ನೆಲೆಯಿಂದ ನೆಲೆಯಿಂದ	ನ ೆ ಲ ೆ ಯ ಿ ಂ ದ ನ ೆ ಲ ೆ ಯ ಿ ಂ ದ	O
ಕೊನೆಯವ ಕೊನೆಯವ	ಕ ೊ ನ ೆ ಯ ವ ಕ ೊ ನ ೆ ಯ ವ	O
ರಾಜಮನೆತನಕ಼್ಕೆ ರಾಜಮನೆತನಕ಼್ಕೆ	ರ ಾ ಜ ಮ ನ ೆ ತ ನ ಕ ್ ಼ ಕ ೆ ರ ಾ ಜ ಮ ನ ೆ ತ ನ ಕ ್ ಼ ಕ ೆ	B-ROL
ನೋಟಗಳನ್ನು ನೋಟಗಳನ್ನು	ನ ೋ ಟ ಗ ಳ ನ ್ ನ ು ನ ೋ ಟ ಗ ಳ ನ ್ ನ ು	O
ಶಾಹುವಿನ ಶಾಹುವಿನ	ಶ ಾ ಹ ು ವ ಿ ನ ಶ ಾ ಹ ು ವ ಿ ನ	B-PER
ಸಂಪೂರ್ಣ ಸಂಪೂರ್ಣ	ಸ ಂ ಪ ೂ ರ ್ ಣ ಸ ಂ ಪ ೂ ರ ್ ಣ	O
ಒಂದು ಒಂದು	ಒ ಂ ದ ು
ಪ್ರವೇಶ ಪ್ರವೇಶ	ಪ ್ ರ ವ ೇ ಶ ಪ ್ ರ ವ ೇ ಶ	O
ಒಪ್ಪಿಸಲು ಒಪ್ಪಿಸಲು	ಒ ಪ ್ ಪ ಿ ಸ ಲ ು ಒ ಪ ್ ಪ ಿ ಸ ಲ ು	O
ಕಡೆಯಿಂದ ಕಡೆಯಿಂದ	ಕ ಡ ೆ ಯ ಿ ಂ ದ ಕ ಡ ೆ ಯ ಿ ಂ ದ	O
. .	. .	O
ಸಾಧ್ಯವಾಗುತ್ತದೆಂಬುದು ಸಾಧ್ಯವಾಗುತ್ತದೆಂಬುದು	ಸ ಾ ಧ ್ ಯ ವ ಾ ಗ ು ತ ್ ತ ದ ೆ ಂ ಬ ು ದ ು ಸ ಾ ಧ ್ ಯ ವ ಾ ಗ ು ತ ್ ತ ದ ೆ ಂ ಬ ು ದ ು	O
. .	. .	O
ಎದುರಿಸಲು ಎದುರಿಸಲು	ಎ ದ ು ರ ಿ ಸ ಲ ು ಎ ದ ು ರ ಿ ಸ ಲ ು	O
ಥಾಮಸ್ ಥಾಮಸ್	ಥ ಾ ಮ ಸ ್ ಥ ಾ ಮ ಸ ್	B-PER
ಅದರಲ್ಲಿ ಅದರಲ್ಲಿ	ಅ ದ ರ ಲ ್ ಲ ಿ ಅ ದ ರ ಲ ್ ಲ ಿ	O
ಇಂಗ್ಲೆಂಡಿಗೆ ಇಂಗ್ಲೆಂಡಿಗೆ	ಇ ಂ ಗ ್ ಲ ೆ ಂ ಡ ಿ ಗ ೆ ಇ ಂ ಗ ್ ಲ ೆ ಂ ಡ ಿ ಗ ೆ	B-LOC
ತನ್ನ ತನ್ನ	ತ ನ ್ ನ ತ ನ ್ ನ	O
. .	. .	O
ಪ್ರದೇಶಗಳಲ್ಲಿ ಪ್ರದೇಶಗಳಲ್ಲಿ	ಪ ್ ರ ದ ೇ ಶ ಗ ಳ ಲ ್ ಲ ಿ ಪ ್ ರ ದ ೇ ಶ ಗ ಳ ಲ ್ ಲ ಿ	O
ಹಾಗೂ ಹಾಗೂ	ಹ ಾ ಗ ೂ ಹ ಾ ಗ ೂ	O
ಆರನೇ ಆರನೇ	ಆ ರ ನ ೇ ಆ ರ ನ ೇ	B-PER
. .	. .	O
ಅತೀ ಅತೀ	ಅ ತ ೀ ಅ ತ ೀ	O
ಕಡೆಗೆ ಕಡೆಗೆ	ಕ ಡ ೆ ಗ ೆ ಕ ಡ ೆ ಗ ೆ	O
ಹೊಂದಿದ್ದನು ಹೊಂದಿದ್ದನು	ಹ ೊ ಂ ದ ಿ ದ ್ ದ ನ ು ಹ ೊ ಂ ದ ಿ ದ ್ ದ ನ ು	O
ಇನ್ನೊಂದು ಇನ್ನೊಂದು	ಇ ನ ್ ನ ೊ ಂ ದ ು ಇ ನ ್ ನ ೊ ಂ ದ ು	O
ಕಾಲದಲ್ಲಿ ಕಾಲದಲ್ಲಿ	ಕ ಾ ಲ ದ ಲ ್ ಲ ಿ ಕ ಾ ಲ ದ ಲ ್ ಲ ಿ	O
ಮರ ಮರ	ಮ ರ ಮ ರ	O
. .	. .	O
. .	. .	O
ಮೂರು ಮೂರು	ಮ ೂ ರ ು
ಅನಾವಶ್ಯಕ ಅನಾವಶ್ಯಕ	ಅ ನ ಾ ವ ಶ ್ ಯ ಕ ಅ ನ ಾ ವ ಶ ್ ಯ ಕ	O
2 2	2
ಮರಣಕ್ಕೂ ಮರಣಕ್ಕೂ	ಮ ರ ಣ ಕ ್ ಕ ೂ ಮ ರ ಣ ಕ ್ ಕ ೂ	O
೧೮ ೧೮	೧ ೮ ೧ ೮	TME
ಅವನಲ಼್ಲಿ ಅವನಲ಼್ಲಿ	ಅ ವ ನ ಲ ್ ಼ ಲ ಿ ಅ ವ ನ ಲ ್ ಼ ಲ ಿ	O
ಅಲ್ಲಿ ಅಲ್ಲಿ	ಅ ಲ ್ ಲ ಿ ಅ ಲ ್ ಲ ಿ	O
	
ಕೆಳಕ್ಕೆ ಕೆಳಕ್ಕೆ	ಕ ೆ ಳ ಕ ್ ಕ ೆ ಕ ೆ ಳ ಕ ್ ಕ ೆ	O
ಸಾಯಿಸಿತು ಸಾಯಿಸಿತು	ಸ ಾ ಯ ಿ ಸ ಿ ತ ು ಸ ಾ ಯ ಿ ಸ ಿ ತ ು	O
ಈ ಈ	ಈ ಈ	O
ಸಾಮಂತರಿಂದ ಸಾಮಂತರಿಂದ	ಸ ಾ ಮ ಂ ತ ರ ಿ ಂ ದ ಸ ಾ ಮ ಂ ತ ರ ಿ ಂ ದ	B-COM
ಭಾಷೆಯಲ್ಲಿ ಭಾಷೆಯಲ್ಲಿ	ಭ ಾ ಷ ೆ ಯ ಲ ್ ಲ ಿ ಭ ಾ ಷ ೆ ಯ ಲ ್ ಲ ಿ	O
	
	
. .	. .	O
ಬಲಿದಾನವನ್ನು ಬಲಿದಾನವನ್ನು	ಬ ಲ ಿ ದ ಾ ನ ವ ನ ್ ನ ು ಬ ಲ ಿ ದ ಾ ನ ವ ನ ್ ನ ು	O
ಚ೦ದ್ರಗುಪ್ತನ ಚ೦ದ್ರಗುಪ್ತನ	ಚ ೦ ದ ್ ರ ಗ ು ಪ ್ ತ ನ ಚ ೦ ದ ್ ರ ಗ ು ಪ ್ ತ ನ	B-PER
ಸಭಯ ಸಭಯ	ಸ ಭ ಯ ಸ ಭ ಯ	O
ಭಾರತದ ಭಾರತದ	ಭ ಾ ರ ತ ದ ಭ ಾ ರ ತ ದ	B-LOC
ಆಂಗ್ಲೋ ಆಂಗ್ಲೋ	ಆ ಂ ಗ ್ ಲ ೊ ೕ ಆ ಂ ಗ ್ ಲ ೊ ೕ	B-COM
ಮತ್ತು ಮತ್ತು	ಮ ತ ್ ತ ು ಮ ತ ್ ತ ು	O
ಮೇಲೆ ಮೇಲೆ	ಮ ೇ ಲ ೆ ಮ ೇ ಲ ೆ	O
ಇಡಲಾಗಿದೆ ಇಡಲಾಗಿದೆ	ಇ ಡ ಲ ಾ ಗ ಿ ದ ೆ ಇ ಡ ಲ ಾ ಗ ಿ ದ ೆ	O
ಬರ್ಡ್ ಬರ್ಡ್	ಬ ರ ್ ಡ ್ ಬ ರ ್ ಡ ್	 PER
ಆಗಿ ಆಗಿ	ಆ ಗ ಿ ಆ ಗ ಿ	O
	
ಸುತ್ತಲೂ ಸುತ್ತಲೂ	ಸ ು ತ ್ ತ ಲ ೂ ಸ ು ತ ್ ತ ಲ ೂ	O
ಮತ್ತು ಮತ್ತು	ಮ ತ ್ ತ ು ಮ ತ ್ ತ ು	O
ನಮ್ಮ ನಮ್ಮ	ನ ಮ ್ ಮ ನ ಮ ್ ಮ	O
ಪ್ರವೃತ್ತಿ ಪ್ರವೃತ್ತಿ	ಪ ್ ರ ವ ೃ ತ ್ ತ ಿ ಪ ್ ರ ವ ೃ ತ ್ ತ ಿ	O
ರಾಜ್ಯ ರಾಜ್ಯ	ರ ಾ ಜ ್ ಯ ರ ಾ ಜ ್ ಯ	O
ಹೆಸರು ಹೆಸರು	ಹ ೆ ಸ ರ ು ಹ ೆ ಸ ರ ು	O
ವೇಲಮರೊಂದಿಗೂ ವೇಲಮರೊಂದಿಗೂ	ವ ೇ ಲ ಮ ರ ೊ ಂ ದ ಿ ಗ ೂ ವ ೇ ಲ ಮ ರ ೊ ಂ ದ ಿ ಗ ೂ	B-PER
ಮೇಲೆ ಮೇಲೆ	ಮ ೇ ಲ ೆ ಮ ೇ ಲ ೆ	O
. .	. .	O
ಸಮುದಾಯದೊಳಗೆ ಸಮುದಾಯದೊಳಗೆ	ಸ ಮ ು ದ ಾ ಯ ದ ೊ ಳ ಗ ೆ ಸ ಮ ು ದ ಾ ಯ ದ ೊ ಳ ಗ ೆ	I-COM
	
ಇಂಗ್ಲೆಂಡ್ ಇಂಗ್ಲೆಂಡ್	ಇ ಂ ಗ ್ ಲ ೆ ಂ ಡ ್ ಇ ಂ ಗ ್ ಲ ೆ ಂ ಡ ್	O
ಸಿಂಗ್ಗೆ ಸಿಂಗ್ಗೆ	ಸ ಿ ಂ ಗ ್ ಗ ೆ ಸ ಿ ಂ ಗ ್ ಗ ೆ	 PER
, ,	, ,	O
	
ಹಕ್ಕು ಹಕ್ಕು	ಹ ಕ ್ ಕ ು ಹ ಕ ್ ಕ ು	O
ಕುಸಿತ ಕುಸಿತ	ಕ ು ಸ ಿ ತ ಕ ು ಸ ಿ ತ	O
. .	. .	O
ಅಲ್ಲಿಯೇ ಅಲ್ಲಿಯೇ	ಅ ಲ ್ ಲ ಿ ಯ ೇ ಅ ಲ ್ ಲ ಿ ಯ ೇ	O
ಸಣ್ಣಸಂಸ್ಥಾನಗಳನ್ನು ಸಣ್ಣಸಂಸ್ಥಾನಗಳನ್ನು	ಸ ಣ ್ ಣ ಸ ಂ ಸ ್ ಥ ಾ ನ ಗ ಳ ನ ್ ನ ು ಸ ಣ ್ ಣ ಸ ಂ ಸ ್ ಥ ಾ ನ ಗ ಳ ನ ್ ನ ು	O
ಅಂಕಿಅಂಶಗಳು ಅಂಕಿಅಂಶಗಳು	ಅ ಂ ಕ ಿ ಅ ಂ ಶ ಗ ಳ ು ಅ ಂ ಕ ಿ ಅ ಂ ಶ ಗ ಳ ು	O
ಹಿಂದೂಧರ್ಮದ ಹಿಂದೂಧರ್ಮದ	ಹ ಿ ಂ ದ ೂ ಧ ರ ್ ಮ ದ ಹ ಿ ಂ ದ ೂ ಧ ರ ್ ಮ ದ	O
	
	
. .	. .	O
ಅಥವಾ ಅಥವಾ	ಅ ಥ ವ ಾ ಅ ಥ ವ ಾ	O
ಪದ್ಧತಿಗಳ ಪದ್ಧತಿಗಳ	ಪ ದ ್ ಧ ತ ಿ ಗ ಳ ಪ ದ ್ ಧ ತ ಿ ಗ ಳ	O
ಅವರ ಅವರ	ಅ ವ ರ ಅ ವ ರ	O
ಒಬ್ಬ ಒಬ್ಬ	ಒ ಬ ್ ಬ ಒ ಬ ್ ಬ	O
ನಡೆದಿದ್ದವು ನಡೆದಿದ್ದವು	ನ ಡ ೆ ದ ಿ ದ ್ ದ ವ ು ನ ಡ ೆ ದ ಿ ದ ್ ದ ವ ು	O
. .	. .	O
ಆಂತರಿಕ ಆಂತರಿಕ	ಆ ಂ ತ ರ ಿ ಕ ಆ ಂ ತ ರ ಿ ಕ	O
. .	. .	O
	
ಪ್ರಧಾನ ಪ್ರಧಾನ	ಪ ್ ರ ಧ ಾ ನ ಪ ್ ರ ಧ ಾ ನ	B-ROL
. .	. .	O
ಉದ್ದೇಶದಿಂದ ಉದ್ದೇಶದಿಂದ	ಉ ದ ್ ದ ೆ ೕ ಶ ದ ಿ ಂ ದ ಉ ದ ್ ದ ೆ ೕ ಶ ದ ಿ ಂ ದ	O
ರಾಷ್ಟ್ರೀಯ ರಾಷ್ಟ್ರೀಯ	ರ ಾ ಷ ್ ಟ ್ ರ ೀ ಯ ರ ಾ ಷ ್ ಟ ್ ರ ೀ ಯ	O
ಪಟೇಲ್ ಪಟೇಲ್	ಪ ಟ ೇ ಲ ್ ಪ ಟ ೇ ಲ ್	 PER
ಇಲ್ತಮಶ್ ಇಲ್ತಮಶ್	ಇ ಲ ್ ತ ಮ ಶ ್ ಇ ಲ ್ ತ ಮ ಶ ್	B-PER
ಪಡೆಯಲು ಪಡೆಯಲು	ಪ ಡ ೆ ಯ ಲ ು ಪ ಡ ೆ ಯ ಲ ು	O
ಅಮಾನುಷ ಅಮಾನುಷ	ಅ ಮ ಾ ನ ು ಷ ಅ ಮ ಾ ನ ು ಷ	O
ಅನೇಕ ಅನೇಕ	ಅ ನ ೇ ಕ ಅ ನ ೇ ಕ	O
ಮನಬಂದಂತೆ ಮನಬಂದಂತೆ	ಮ ನ ಬ ಂ ದ ಂ ತ ೆ ಮ ನ ಬ ಂ ದ ಂ ತ ೆ	O
ಧನನಂದನ ಧನನಂದನ	ಧ ನ ನ ಂ ದ ನ ಧ ನ ನ ಂ ದ ನ	O
ಹದಿನಾರನೇ ಹದಿನಾರನೇ	ಹ ದ ಿ ನ ಾ ರ ನ ೇ ಹ ದ ಿ ನ ಾ ರ ನ ೇ	TME
ಪರಿಷತ್ತು ಪರಿಷತ್ತು	ಪ ರ ಿ ಷ ತ ್ ತ ು ಪ ರ ಿ ಷ ತ ್ ತ ು	O
ಸಂಸ್ಥಾನಿಕನ ಸಂಸ್ಥಾನಿಕನ	ಸ ಂ ಸ ್ ಥ ಾ ನ ಿ ಕ ನ ಸ ಂ ಸ ್ ಥ ಾ ನ ಿ ಕ ನ	O
ಹದಿನೆಂಟು ಹದಿನೆಂಟು	ಹ ದ ಿ ನ ೆ ಂ ಟ ು
. .	. .	O
ಮರಾಠಾ ಮರಾಠಾ	ಮ ರ ಾ ಠ ಾ ಮ ರ ಾ ಠ ಾ	B-COM
ಇರುವಿಕೆಯನ್ನು ಇರುವಿಕೆಯನ್ನು	ಇ ರ ು ವ ಿ ಕ ೆ ಯ ನ ್ ನ ು ಇ ರ ು ವ ಿ ಕ ೆ ಯ ನ ್ ನ ು	O
ಕೇಂದ್ರದಲ್ಲಿ ಕೇಂದ್ರದಲ್ಲಿ	ಕ ೇ ಂ ದ ್ ರ ದ ಲ ್ ಲ ಿ ಕ ೇ ಂ ದ ್ ರ ದ ಲ ್ ಲ ಿ	O
ನಾಗದತ್ತ ನಾಗದತ್ತ	ನ ಾ ಗ ದ ತ ್ ತ ನ ಾ ಗ ದ ತ ್ ತ	B-PER
ಕಲಿತರು ಕಲಿತರು	ಕ ಲ ಿ ತ ರ ು ಕ ಲ ಿ ತ ರ ು	O
ದೇವಾಲಯವಾದರೆ ದೇವಾಲಯವಾದರೆ	ದ ೇ ವ ಾ ಲ ಯ ವ ಾ ದ ರ ೆ ದ ೇ ವ ಾ ಲ ಯ ವ ಾ ದ ರ ೆ	O
ಸಮಯದಲ್ಲಿ ಸಮಯದಲ್ಲಿ	ಸ ಮ ಯ ದ ಲ ್ ಲ ಿ ಸ ಮ ಯ ದ ಲ ್ ಲ ಿ	O
ಅವರ ಅವರ	ಅ ವ ರ ಅ ವ ರ	O
ಎಂದು ಎಂದು	ಎ ಂ ದ ು ಎ ಂ ದ ು	O
ತಮ್ಮ ತಮ್ಮ	ತ ಮ ್ ಮ ತ ಮ ್ ಮ	O
ಹಾಗೂ ಹಾಗೂ	ಹ ಾ ಗ ೂ ಹ ಾ ಗ ೂ	O
. .	. .	O
ಐಹೊಳೆಯು ಐಹೊಳೆಯು	ಐ ಹ ೊ ಳ ೆ ಯ ು ಐ ಹ ೊ ಳ ೆ ಯ ು	B-LOC
ಪಟ್ಟಕ್ಕೆ ಪಟ್ಟಕ್ಕೆ	ಪ ಟ ್ ಟ ಕ ್ ಕ ೆ ಪ ಟ ್ ಟ ಕ ್ ಕ ೆ	O
ಆಸಕ್ತಿಯಿರಲಿಲ್ಲ ಆಸಕ್ತಿಯಿರಲಿಲ್ಲ	ಆ ಸ ಕ ್ ತ ಿ ಯ ಿ ರ ಲ ಿ ಲ ್ ಲ ಆ ಸ ಕ ್ ತ ಿ ಯ ಿ ರ ಲ ಿ ಲ ್ ಲ	O
ರಚಿಸಿದನು ರಚಿಸಿದನು	ರ ಚ ಿ ಸ ಿ ದ ನ ು ರ ಚ ಿ ಸ ಿ ದ ನ ು	O
ಯಾಗಲಿಲ್ಲ ಯಾಗಲಿಲ್ಲ	ಯ ಾ ಗ ಲ ಿ ಲ ್ ಲ ಯ ಾ ಗ ಲ ಿ ಲ ್ ಲ	O
ಇವನ ಇವನ	ಇ ವ ನ ಇ ವ ನ	O
ಹೀಗೆ ಹೀಗೆ	ಹ ೀ ಗ ೆ ಹ ೀ ಗ ೆ	O
೧೧೨೬ ೧೧೨೬	೧ ೧ ೨ ೬ ೧ ೧ ೨ ೬	TME
ಆಂದೋಲನವನ್ನು ಆಂದೋಲನವನ್ನು	ಆ ಂ ದ ೋ ಲ ನ ವ ನ ್ ನ ು ಆ ಂ ದ ೋ ಲ ನ ವ ನ ್ ನ ು	O
ಪೇಶ್ವೆಯರ ಪೇಶ್ವೆಯರ	ಪ ೇ ಶ ್ ವ ೆ ಯ ರ ಪ ೇ ಶ ್ ವ ೆ ಯ ರ	B-COM
ಚರಿತ್ರೆಯನ್ನು ಚರಿತ್ರೆಯನ್ನು	ಚ ರ ಿ ತ ್ ರ ೆ ಯ ನ ್ ನ ು ಚ ರ ಿ ತ ್ ರ ೆ ಯ ನ ್ ನ ು	O
ರೂಪದಲ್ಲಿ ರೂಪದಲ್ಲಿ	ರ ೂ ಪ ದ ಲ ್ ಲ ಿ ರ ೂ ಪ ದ ಲ ್ ಲ ಿ	O
ಅದು ಅದು	ಅ ದ ು ಅ ದ ು	O
ನಾಲ್ವಡಿ ನಾಲ್ವಡಿ	ನ ಾ ಲ ್ ವ ಡ ಿ ನ ಾ ಲ ್ ವ ಡ ಿ	B-ROL
ಬದಲಾವಣೆಗೆ ಬದಲಾವಣೆಗೆ	ಬ ದ ಲ ಾ ವ ಣ ೆ ಗ ೆ ಬ ದ ಲ ಾ ವ ಣ ೆ ಗ ೆ	O
ಈಗ ಈಗ	ಈ ಗ ಈ ಗ	O
ವಿಶ್ವಾಸರಾವ್ ವಿಶ್ವಾಸರಾವ್	ವ ಿ ಶ ್ ವ ಾ ಸ ರ ಾ ವ ್ ವ ಿ ಶ ್ ವ ಾ ಸ ರ ಾ ವ ್	B-PER
ಕಕ್ಕ2 ಕಕ್ಕ2	ಕ ಕ ್ ಕ 2 ಕ ಕ ್ ಕ 2	O
ಆರನೇಯ ಆರನೇಯ	ಆ ರ ನ ೇ ಯ ಆ ರ ನ ೇ ಯ	B-PER
. .	. .	O
ಪೋರ್ಚುಗೀಸ್ ಪೋರ್ಚುಗೀಸ್	ಪ ೋ ರ ್ ಚ ು ಗ ೀ ಸ ್ ಪ ೋ ರ ್ ಚ ು ಗ ೀ ಸ ್	B-COM
ಪ್ರಮುಖವಾದುದು ಪ್ರಮುಖವಾದುದು	ಪ ್ ರ ಮ ು ಖ ವ ಾ ದ ು ದ ು ಪ ್ ರ ಮ ು ಖ ವ ಾ ದ ು ದ ು	O
	
ಕಾರ್ಯಕ್ರಮದಲ್ಲಿ ಕಾರ್ಯಕ್ರಮದಲ್ಲಿ	ಕ ಾ ರ ್ ಯ ಕ ್ ರ ಮ ದ ಲ ್ ಲ ಿ ಕ ಾ ರ ್ ಯ ಕ ್ ರ ಮ ದ ಲ ್ ಲ ಿ	O
. .	. .	O
. .	. .	O
ಷಾ ಷಾ	ಷ ಾ ಷ ಾ	 PER
ಸದಸ್ಯತ್ವ ಸದಸ್ಯತ್ವ	ಸ ದ ಸ ್ ಯ ತ ್ ವ ಸ ದ ಸ ್ ಯ ತ ್ ವ	O
ಮತ್ತು ಮತ್ತು	ಮ ತ ್ ತ ು ಮ ತ ್ ತ ು	O
ಮತ್ತು ಮತ್ತು	ಮ ತ ್ ತ ು ಮ ತ ್ ತ ು	O
	
ಗೆದ್ದುಕೊಂಡನು ಗೆದ್ದುಕೊಂಡನು	ಗ ೆ ದ ್ ದ ು ಕ ೊ ಂ ಡ ನ ು ಗ ೆ ದ ್ ದ ು ಕ ೊ ಂ ಡ ನ ು	O
, ,	, ,	O
ಎದುರಾದವು ಎದುರಾದವು	ಎ ದ ು ರ ಾ ದ ವ ು ಎ ದ ು ರ ಾ ದ ವ ು	O
ಅಂದರೆ ಅಂದರೆ	ಅ ಂ ದ ರ ೆ ಅ ಂ ದ ರ ೆ	O
	
ಬೆಂಬಲವನ್ನು ಬೆಂಬಲವನ್ನು	ಬ ೆ ಂ ಬ ಲ ವ ನ ್ ನ ು ಬ ೆ ಂ ಬ ಲ ವ ನ ್ ನ ು	O
. .	. .	O
ಇದ್ದರು ಇದ್ದರು	ಇ ದ ್ ದ ರ ು ಇ ದ ್ ದ ರ ು	O
ಮಹಿಳೆಯರನ್ನು ಮಹಿಳೆಯರನ್ನು	ಮ ಹ ಿ ಳ ೆ ಯ ರ ನ ್ ನ ು ಮ ಹ ಿ ಳ ೆ ಯ ರ ನ ್ ನ ು	O
ಗೋವೆಯ ಗೋವೆಯ	ಗ ೋ ವ ೆ ಯ ಗ ೋ ವ ೆ ಯ	B-COM
. .	. .	O
ಅದರಲ್ಲೂ ಅದರಲ್ಲೂ	ಅ ದ ರ ಲ ್ ಲ ೂ ಅ ದ ರ ಲ ್ ಲ ೂ	O
ಕೆಂಪೇಗೌಡನ ಕೆಂಪೇಗೌಡನ	ಕ ೆ ಂ ಪ ೇ ಗ ೌ ಡ ನ ಕ ೆ ಂ ಪ ೇ ಗ ೌ ಡ ನ	B-PER
, ,	, ,	O
ದಕ್ಷಿಣಭಾರತದ ದಕ್ಷಿಣಭಾರತದ	ದ ಕ ್ ಷ ಿ ಣ ಭ ಾ ರ ತ ದ ದ ಕ ್ ಷ ಿ ಣ ಭ ಾ ರ ತ ದ	B-LOC
ಫಲವಾಗಿ ಫಲವಾಗಿ	ಫ ಲ ವ ಾ ಗ ಿ ಫ ಲ ವ ಾ ಗ ಿ	O
ಕೈಬಿಡುವುದು ಕೈಬಿಡುವುದು	ಕ ೈ ಬ ಿ ಡ ು ವ ು ದ ು ಕ ೈ ಬ ಿ ಡ ು ವ ು ದ ು	O
ದತ್ತಕ ದತ್ತಕ	ದ ತ ್ ತ ಕ ದ ತ ್ ತ ಕ	O
ದ್ವೈತ ದ್ವೈತ	ದ ್ ವ ೆ ೖ ತ ದ ್ ವ ೆ ೖ ತ	O
ಪೇಟೆ ಪೇಟೆ	ಪ ೇ ಟ ೆ ಪ ೇ ಟ ೆ	 LOC
. .	. .	O
ದಕ್ಷಿಣಭಾರತದ ದಕ್ಷಿಣಭಾರತದ	ದ ಕ ್ ಷ ಿ ಣ ಭ ಾ ರ ತ ದ ದ ಕ ್ ಷ ಿ ಣ ಭ ಾ ರ ತ ದ	B-LOC
70 70	7 0
ಗಾಂಧಿಯವರು ಗಾಂಧಿಯವರು	ಗ ಾ ಂ ಧ ಿ ಯ ವ ರ ು ಗ ಾ ಂ ಧ ಿ ಯ ವ ರ ು	B-PER
ಸುಲ್ತಾನ್ ಸುಲ್ತಾನ್	ಸ ು ಲ ್ ತ ಾ ನ ್ ಸ ು ಲ ್ ತ ಾ ನ ್	 PER
ಮೌರ್ಯ ಮೌರ್ಯ	ಮ ೌ ರ ್ ಯ ಮ ೌ ರ ್ ಯ	B-COM
ಅಮೆರಿಕವು ಅಮೆರಿಕವು	ಅ ಮ ೆ ರ ಿ ಕ ವ ು ಅ ಮ ೆ ರ ಿ ಕ ವ ು	B-LOC
ಮೊಘಲ್ ಮೊಘಲ್	ಮ ೊ ಘ ಲ ್ ಮ ೊ ಘ ಲ ್	B-COM
ಅಭಿಯಾನವನ್ನು ಅಭಿಯಾನವನ್ನು	ಅ ಭ ಿ ಯ ಾ ನ ವ ನ ್ ನ ು ಅ ಭ ಿ ಯ ಾ ನ ವ ನ ್ ನ ು	O
ಮೂಲಗಳಿಂದ ಮೂಲಗಳಿಂದ	ಮ ೂ ಲ ಗ ಳ ಿ ಂ ದ ಮ ೂ ಲ ಗ ಳ ಿ ಂ ದ	O
. .	. .	O
	
ಹಾಗೂ ಹಾಗೂ	ಹ ಾ ಗ ೂ ಹ ಾ ಗ ೂ	O
ಕಿತ್ತೂರು ಕಿತ್ತೂರು	ಕ ಿ ತ ್ ತ ೂ ರ ು ಕ ಿ ತ ್ ತ ೂ ರ ು	B-LOC
ಬೇಕಾಯಿತು ಬೇಕಾಯಿತು	ಬ ೇ ಕ ಾ ಯ ಿ ತ ು ಬ ೇ ಕ ಾ ಯ ಿ ತ ು	O
ಖಜಾನೆಯಲ್ಲಿರುವ ಖಜಾನೆಯಲ್ಲಿರುವ	ಖ ಜ ಾ ನ ೆ ಯ ಲ ್ ಲ ಿ ರ ು ವ ಖ ಜ ಾ ನ ೆ ಯ ಲ ್ ಲ ಿ ರ ು ವ	O
ಅವಳು ಅವಳು	ಅ ವ ಳ ು ಅ ವ ಳ ು	O
	
ಶಾ ಶಾ	ಶ ಾ ಶ ಾ	B-PER
ಬಾಬರ್ನ ಬಾಬರ್ನ	ಬ ಾ ಬ ರ ್ ನ ಬ ಾ ಬ ರ ್ ನ	B-PER
	
ಉಪಯೋಗಿಸಿಕೊಂಡಿತು ಉಪಯೋಗಿಸಿಕೊಂಡಿತು	ಉ ಪ ಯ ೋ ಗ ಿ ಸ ಿ ಕ ೊ ಂ ಡ ಿ ತ ು ಉ ಪ ಯ ೋ ಗ ಿ ಸ ಿ ಕ ೊ ಂ ಡ ಿ ತ ು	O
	
	
	
ರಾಣಾ ರಾಣಾ	ರ ಾ ಣ ಾ ರ ಾ ಣ ಾ	B-PER
ನೀಡಲಿ ನೀಡಲಿ	ನ ೀ ಡ ಲ ಿ ನ ೀ ಡ ಲ ಿ	O
. .	. .	O
ಗೋಡೆಗಳು ಗೋಡೆಗಳು	ಗ ೋ ಡ ೆ ಗ ಳ ು ಗ ೋ ಡ ೆ ಗ ಳ ು	O
ಚೆಲ್ಲುತ್ತವೆ ಚೆಲ್ಲುತ್ತವೆ	ಚ ೆ ಲ ್ ಲ ು ತ ್ ತ ವ ೆ ಚ ೆ ಲ ್ ಲ ು ತ ್ ತ ವ ೆ	O
	
೧೫೫೩೧೫೫೬ ೧೫೫೩೧೫೫೬	೧ ೫ ೫ ೩ ೧ ೫ ೫ ೬ ೧ ೫ ೫ ೩ ೧ ೫ ೫ ೬	TME
ರಾಜ್ಯಗಳು ರಾಜ್ಯಗಳು	ರ ಾ ಜ ್ ಯ ಗ ಳ ು ರ ಾ ಜ ್ ಯ ಗ ಳ ು	O
ಬನವಾಸಿ ಬನವಾಸಿ	ಬ ನ ವ ಾ ಸ ಿ ಬ ನ ವ ಾ ಸ ಿ	 LOC
ಹಾಗೂ ಹಾಗೂ	ಹ ಾ ಗ ೂ ಹ ಾ ಗ ೂ	O
ಮತ್ತು ಮತ್ತು	ಮ ತ ್ ತ ು ಮ ತ ್ ತ ು	O
ಶೇಖರಣೆಗಾಗಿ ಶೇಖರಣೆಗಾಗಿ	ಶ ೇ ಖ ರ ಣ ೆ ಗ ಾ ಗ ಿ ಶ ೇ ಖ ರ ಣ ೆ ಗ ಾ ಗ ಿ	O
ಗೊತ್ತಾಗುವುದು ಗೊತ್ತಾಗುವುದು	ಗ ೊ ತ ್ ತ ಾ ಗ ು ವ ು ದ ು ಗ ೊ ತ ್ ತ ಾ ಗ ು ವ ು ದ ು	O
ಒಂದು ಒಂದು	ಒ ಂ ದ ು ಒ ಂ ದ ು	O
	
	
	
ಅವನು ಅವನು	ಅ ವ ನ ು ಅ ವ ನ ು	O
ನಾಯಕನಿಗೆ ನಾಯಕನಿಗೆ	ನ ಾ ಯ ಕ ನ ಿ ಗ ೆ ನ ಾ ಯ ಕ ನ ಿ ಗ ೆ	O
972ರಲ್ಲಿ 972ರಲ್ಲಿ	9 7 2 ರ ಲ ್ ಲ ಿ 9 7 2 ರ ಲ ್ ಲ ಿ	TME
ಎರಡೂ ಎರಡೂ	ಎ ರ ಡ ೂ
ಅದು ಅದು	ಅ ದ ು ಅ ದ ು	O
	
ಯಾರ್ಕ್ ಯಾರ್ಕ್	ಯ ಾ ರ ್ ಕ ್ ಯ ಾ ರ ್ ಕ ್	 LOC
ಪ್ರಮುಖ ಪ್ರಮುಖ	ಪ ್ ರ ಮ ು ಖ ಪ ್ ರ ಮ ು ಖ	O
ಕಲವೇ ಕಲವೇ	ಕ ಲ ವ ೇ ಕ ಲ ವ ೇ	O
ಅಭಿಪ್ರಾಯದಿಂದ ಅಭಿಪ್ರಾಯದಿಂದ	ಅ ಭ ಿ ಪ ್ ರ ಾ ಯ ದ ಿ ಂ ದ ಅ ಭ ಿ ಪ ್ ರ ಾ ಯ ದ ಿ ಂ ದ	O
. .	. .	O
	
ಕೃತ್ಯಗಳಲ್ಲಿ ಕೃತ್ಯಗಳಲ್ಲಿ	ಕ ೃ ತ ್ ಯ ಗ ಳ ಲ ್ ಲ ಿ ಕ ೃ ತ ್ ಯ ಗ ಳ ಲ ್ ಲ ಿ	O
ಮತ್ತು ಮತ್ತು	ಮ ತ ್ ತ ು ಮ ತ ್ ತ ು	O
	
	
ಪ್ರಾದೇಶಿಕ ಪ್ರಾದೇಶಿಕ	ಪ ್ ರ ಾ ದ ೇ ಶ ಿ ಕ ಪ ್ ರ ಾ ದ ೇ ಶ ಿ ಕ	O
ಮತ್ತು ಮತ್ತು	ಮ ತ ್ ತ ು ಮ ತ ್ ತ ು	O
ಹೈದರಾಬಾದ್ ಹೈದರಾಬಾದ್	ಹ ೈ ದ ರ ಾ ಬ ಾ ದ ್ ಹ ೈ ದ ರ ಾ ಬ ಾ ದ ್	 LOC
ವ್ಯಾಖ್ಯಾನ ವ್ಯಾಖ್ಯಾನ	ವ ್ ಯ ಾ ಖ ್ ಯ ಾ ನ ವ ್ ಯ ಾ ಖ ್ ಯ ಾ ನ	O
ಬಳಲುತ್ತಿರುವ ಬಳಲುತ್ತಿರುವ	ಬ ಳ ಲ ು ತ ್ ತ ಿ ರ ು ವ ಬ ಳ ಲ ು ತ ್ ತ ಿ ರ ು ವ	O
ಕಾಲದ ಕಾಲದ	ಕ ಾ ಲ ದ ಕ ಾ ಲ ದ	O
. .	. .	O
ಬೇಟೆ ಬೇಟೆ	ಬ ೇ ಟ ೆ ಬ ೇ ಟ ೆ	O
ಭಾರತದಲ್ಲಿ ಭಾರತದಲ್ಲಿ	ಭ ಾ ರ ತ ದ ಲ ್ ಲ ಿ ಭ ಾ ರ ತ ದ ಲ ್ ಲ ಿ	B-LOC
ಅವಳು ಅವಳು	ಅ ವ ಳ ು ಅ ವ ಳ ು	O
	
ಅರಮನೆಯನ್ನು ಅರಮನೆಯನ್ನು	ಅ ರ ಮ ನ ೆ ಯ ನ ್ ನ ು ಅ ರ ಮ ನ ೆ ಯ ನ ್ ನ ು	O
ಇದಕ್ಕೆ ಇದಕ್ಕೆ	ಇ ದ ಕ ್ ಕ ೆ ಇ ದ ಕ ್ ಕ ೆ	O
ವಯಸ್ಸಿನಲ್ಲಿಯೇ ವಯಸ್ಸಿನಲ್ಲಿಯೇ	ವ ಯ ಸ ್ ಸ ಿ ನ ಲ ್ ಲ ಿ ಯ ೇ ವ ಯ ಸ ್ ಸ ಿ ನ ಲ ್ ಲ ಿ ಯ ೇ	TME
, ,	, ,	O
. .	. .	O
ರಾಣಿ ರಾಣಿ	ರ ಾ ಣ ಿ ರ ಾ ಣ ಿ	I-ROL
ಕುಲ ಕುಲ	ಕ ು ಲ ಕ ು ಲ	O
ಸರ್ಕಾರ ಸರ್ಕಾರ	ಸ ರ ್ ಕ ಾ ರ ಸ ರ ್ ಕ ಾ ರ	O
ಮಾಂಸದೊಂದಿಗೆ ಮಾಂಸದೊಂದಿಗೆ	ಮ ಾ ಂ ಸ ದ ೊ ಂ ದ ಿ ಗ ೆ ಮ ಾ ಂ ಸ ದ ೊ ಂ ದ ಿ ಗ ೆ	O
	
ಸಾಮ್ರಾಜ್ಯದಲ್ಲಿ ಸಾಮ್ರಾಜ್ಯದಲ್ಲಿ	ಸ ಾ ಮ ್ ರ ಾ ಜ ್ ಯ ದ ಲ ್ ಲ ಿ ಸ ಾ ಮ ್ ರ ಾ ಜ ್ ಯ ದ ಲ ್ ಲ ಿ	ORG
ಕುಂದುತ್ತಾ ಕುಂದುತ್ತಾ	ಕ ು ಂ ದ ು ತ ್ ತ ಾ ಕ ು ಂ ದ ು ತ ್ ತ ಾ	O
ನದಿಯವರೆಗೆ ನದಿಯವರೆಗೆ	ನ ದ ಿ ಯ ವ ರ ೆ ಗ ೆ ನ ದ ಿ ಯ ವ ರ ೆ ಗ ೆ	 LOC
. .	. .	O
ದಾಳಿ ದಾಳಿ	ದ ಾ ಳ ಿ ದ ಾ ಳ ಿ	O
ಅಭಿಪ್ರಾಯದಲ್ಲಿ ಅಭಿಪ್ರಾಯದಲ್ಲಿ	ಅ ಭ ಿ ಪ ್ ರ ಾ ಯ ದ ಲ ್ ಲ ಿ ಅ ಭ ಿ ಪ ್ ರ ಾ ಯ ದ ಲ ್ ಲ ಿ	O
ಆ ಆ	ಆ ಆ	O
. .	. .	O
. .	. .	O
	
	
ಹಾಗೂ ಹಾಗೂ	ಹ ಾ ಗ ೂ ಹ ಾ ಗ ೂ	O
	
. .	. .	O
ಮಕ್ಕಳು ಮಕ್ಕಳು	ಮ ಕ ್ ಕ ಳ ು ಮ ಕ ್ ಕ ಳ ು	B-ROL
ರಚನೆಯಲ್ಲಿ ರಚನೆಯಲ್ಲಿ	ರ ಚ ನ ೆ ಯ ಲ ್ ಲ ಿ ರ ಚ ನ ೆ ಯ ಲ ್ ಲ ಿ	O
ಸಿಂಧಿಯಾರು ಸಿಂಧಿಯಾರು	ಸ ಿ ಂ ಧ ಿ ಯ ಾ ರ ು ಸ ಿ ಂ ಧ ಿ ಯ ಾ ರ ು	 LOC
ಬಹುದೇವತಾ ಬಹುದೇವತಾ	ಬ ಹ ು ದ ೇ ವ ತ ಾ ಬ ಹ ು ದ ೇ ವ ತ ಾ	O
ಸ್ಥಾಪಿಸಿದರು ಸ್ಥಾಪಿಸಿದರು	ಸ ್ ಥ ಾ ಪ ಿ ಸ ಿ ದ ರ ು ಸ ್ ಥ ಾ ಪ ಿ ಸ ಿ ದ ರ ು	O
ಸುಟ್ಟು ಸುಟ್ಟು	ಸ ು ಟ ್ ಟ ು ಸ ು ಟ ್ ಟ ು	O
ದಾಳಿ ದಾಳಿ	ದ ಾ ಳ ಿ ದ ಾ ಳ ಿ	O
ಪ್ರಮುಖ ಪ್ರಮುಖ	ಪ ್ ರ ಮ ು ಖ ಪ ್ ರ ಮ ು ಖ	O
ಸಲ ಸಲ	ಸ ಲ ಸ ಲ	O
ನಿಸರ್ಗ ನಿಸರ್ಗ	ನ ಿ ಸ ರ ್ ಗ ನ ಿ ಸ ರ ್ ಗ	O
ಸಮ್ಮೇಳನವನ್ನು ಸಮ್ಮೇಳನವನ್ನು	ಸ ಮ ್ ಮ ೇ ಳ ನ ವ ನ ್ ನ ು ಸ ಮ ್ ಮ ೇ ಳ ನ ವ ನ ್ ನ ು	O
ಅತ್ಯಂತ ಅತ್ಯಂತ	ಅ ತ ್ ಯ ಂ ತ ಅ ತ ್ ಯ ಂ ತ	O
ಆಗಮಿಸಿದರು ಆಗಮಿಸಿದರು	ಆ ಗ ಮ ಿ ಸ ಿ ದ ರ ು ಆ ಗ ಮ ಿ ಸ ಿ ದ ರ ು	O
	
ಹೆಚ್ಚು ಹೆಚ್ಚು	ಹ ೆ ಚ ್ ಚ ು ಹ ೆ ಚ ್ ಚ ು	O
ಶಿಕ್ಷಿಸಲು ಶಿಕ್ಷಿಸಲು	ಶ ಿ ಕ ್ ಷ ಿ ಸ ಲ ು ಶ ಿ ಕ ್ ಷ ಿ ಸ ಲ ು	O
ಅಲ್ಲದೇ ಅಲ್ಲದೇ	ಅ ಲ ್ ಲ ದ ೇ ಅ ಲ ್ ಲ ದ ೇ	O
ಇದು ಇದು	ಇ ದ ು ಇ ದ ು	O
ವರೆವಿಗೂ ವರೆವಿಗೂ	ವ ರ ೆ ವ ಿ ಗ ೂ ವ ರ ೆ ವ ಿ ಗ ೂ	O
ಮಧುರೆಯ ಮಧುರೆಯ	ಮ ಧ ು ರ ೆ ಯ ಮ ಧ ು ರ ೆ ಯ	B-LOC
	
ಪ್ರಸಿದ್ಧವಾದ ಪ್ರಸಿದ್ಧವಾದ	ಪ ್ ರ ಸ ಿ ದ ್ ಧ ವ ಾ ದ ಪ ್ ರ ಸ ಿ ದ ್ ಧ ವ ಾ ದ	O
ವಿಧ್ವಂಸಕ ವಿಧ್ವಂಸಕ	ವ ಿ ಧ ್ ವ ಂ ಸ ಕ ವ ಿ ಧ ್ ವ ಂ ಸ ಕ	O
ಚಾಚಿತ್ತು ಚಾಚಿತ್ತು	ಚ ಾ ಚ ಿ ತ ್ ತ ು ಚ ಾ ಚ ಿ ತ ್ ತ ು	O
ಆತ ಆತ	ಆ ತ ಆ ತ	O
ಸುಲ್ತಾನಾ ಸುಲ್ತಾನಾ	ಸ ು ಲ ್ ತ ಾ ನ ಾ ಸ ು ಲ ್ ತ ಾ ನ ಾ	B-COM
ಅಭಿವೃದ್ಧಿಯಾಯಿತು ಅಭಿವೃದ್ಧಿಯಾಯಿತು	ಅ ಭ ಿ ವ ೃ ದ ್ ಧ ಿ ಯ ಾ ಯ ಿ ತ ು ಅ ಭ ಿ ವ ೃ ದ ್ ಧ ಿ ಯ ಾ ಯ ಿ ತ ು	O
ಆಕ್ರಮಣನೀತಿಯನ್ನು ಆಕ್ರಮಣನೀತಿಯನ್ನು	ಆ ಕ ್ ರ ಮ ಣ ನ ೀ ತ ಿ ಯ ನ ್ ನ ು ಆ ಕ ್ ರ ಮ ಣ ನ ೀ ತ ಿ ಯ ನ ್ ನ ು	O
1498ರಲ್ಲಿ 1498ರಲ್ಲಿ	1 4 9 8 ರ ಲ ್ ಲ ಿ 1 4 9 8 ರ ಲ ್ ಲ ಿ	TME
ಕೃತಿಗಳನ್ನು ಕೃತಿಗಳನ್ನು	ಕ ೃ ತ ಿ ಗ ಳ ನ ್ ನ ು ಕ ೃ ತ ಿ ಗ ಳ ನ ್ ನ ು	O
ಕಂಡನು ಕಂಡನು	ಕ ಂ ಡ ನ ು ಕ ಂ ಡ ನ ು	O
ನಿರ್ಮೂಲನ ನಿರ್ಮೂಲನ	ನ ಿ ರ ್ ಮ ೂ ಲ ನ ನ ಿ ರ ್ ಮ ೂ ಲ ನ	O
ಸಂಗತಿಯನ್ನು ಸಂಗತಿಯನ್ನು	ಸ ಂ ಗ ತ ಿ ಯ ನ ್ ನ ು ಸ ಂ ಗ ತ ಿ ಯ ನ ್ ನ ು	O
ವಿಭಾಗಗಳನ್ನಾಗಿ ವಿಭಾಗಗಳನ್ನಾಗಿ	ವ ಿ ಭ ಾ ಗ ಗ ಳ ನ ್ ನ ಾ ಗ ಿ ವ ಿ ಭ ಾ ಗ ಗ ಳ ನ ್ ನ ಾ ಗ ಿ	O
ಬರತೊಡಗಿದವು ಬರತೊಡಗಿದವು	ಬ ರ ತ ೊ ಡ ಗ ಿ ದ ವ ು ಬ ರ ತ ೊ ಡ ಗ ಿ ದ ವ ು	O
. .	. .	O
ಧಾರವಾಡಕ್ಕೆ ಧಾರವಾಡಕ್ಕೆ	ಧ ಾ ರ ವ ಾ ಡ ಕ ್ ಕ ೆ ಧ ಾ ರ ವ ಾ ಡ ಕ ್ ಕ ೆ	B-LOC
ಒಪ್ಪಿಸಲಾಯಿತು ಒಪ್ಪಿಸಲಾಯಿತು	ಒ ಪ ್ ಪ ಿ ಸ ಲ ಾ ಯ ಿ ತ ು ಒ ಪ ್ ಪ ಿ ಸ ಲ ಾ ಯ ಿ ತ ು	O
ಸ್ವಾಮಿಗಳೊಂದಿಗೆ ಸ್ವಾಮಿಗಳೊಂದಿಗೆ	ಸ ್ ವ ಾ ಮ ಿ ಗ ಳ ೊ ಂ ದ ಿ ಗ ೆ ಸ ್ ವ ಾ ಮ ಿ ಗ ಳ ೊ ಂ ದ ಿ ಗ ೆ	 PER
ನೆನಪಿಗಾಗಿ ನೆನಪಿಗಾಗಿ	ನ ೆ ನ ಪ ಿ ಗ ಾ ಗ ಿ ನ ೆ ನ ಪ ಿ ಗ ಾ ಗ ಿ	O
. .	. .	O
, ,	, ,	O
ಕೆಲಸ ಕೆಲಸ	ಕ ೆ ಲ ಸ ಕ ೆ ಲ ಸ	O
ತಾನು ತಾನು	ತ ಾ ನ ು ತ ಾ ನ ು	O
	
ಕ್ರಿ ಕ್ರಿ	ಕ ್ ರ ಿ ಕ ್ ರ ಿ	O
ಮತ್ತು ಮತ್ತು	ಮ ತ ್ ತ ು ಮ ತ ್ ತ ು	O
ಭಾರತಕ್ಕೆ ಭಾರತಕ್ಕೆ	ಭ ಾ ರ ತ ಕ ್ ಕ ೆ ಭ ಾ ರ ತ ಕ ್ ಕ ೆ	 LOC
ಬ್ರಹ್ಮ ಬ್ರಹ್ಮ	ಬ ್ ರ ಹ ್ ಮ ಬ ್ ರ ಹ ್ ಮ	O
ತನ್ನ ತನ್ನ	ತ ನ ್ ನ ತ ನ ್ ನ	O
ಬೆಳವಣಿಗೆಯ ಬೆಳವಣಿಗೆಯ	ಬ ೆ ಳ ವ ಣ ಿ ಗ ೆ ಯ ಬ ೆ ಳ ವ ಣ ಿ ಗ ೆ ಯ	O
ಜನವರಿ ಜನವರಿ	ಜ ನ ವ ರ ಿ ಜ ನ ವ ರ ಿ	TME
ಮಹಾರಾಣಾ ಮಹಾರಾಣಾ	ಮ ಹ ಾ ರ ಾ ಣ ಾ ಮ ಹ ಾ ರ ಾ ಣ ಾ	B-PER
	
	
ಆಗ್ರಾ ಆಗ್ರಾ	ಆ ಗ ್ ರ ಾ ಆ ಗ ್ ರ ಾ	 LOC
ದಿವಾಣ ದಿವಾಣ	ದ ಿ ವ ಾ ಣ ದ ಿ ವ ಾ ಣ	O
ಸಂಖ್ಯೆಯಲ್ಲಿವೆ ಸಂಖ್ಯೆಯಲ್ಲಿವೆ	ಸ ಂ ಖ ್ ಯ ೆ ಯ ಲ ್ ಲ ಿ ವ ೆ ಸ ಂ ಖ ್ ಯ ೆ ಯ ಲ ್ ಲ ಿ ವ ೆ	O
ತನ್ನ ತನ್ನ	ತ ನ ್ ನ ತ ನ ್ ನ	O
ಅಲ್ಲಲ್ಲಿ ಅಲ್ಲಲ್ಲಿ	ಅ ಲ ್ ಲ ಲ ್ ಲ ಿ ಅ ಲ ್ ಲ ಲ ್ ಲ ಿ	O
ಕುದುರೆ ಕುದುರೆ	ಕ ು ದ ು ರ ೆ ಕ ು ದ ು ರ ೆ	O
ಹಕ್ಕನ್ನು ಹಕ್ಕನ್ನು	ಹ ಕ ್ ಕ ನ ್ ನ ು ಹ ಕ ್ ಕ ನ ್ ನ ು	O
. .	. .	O
12 12	1 2
ಅವಳು ಅವಳು	ಅ ವ ಳ ು ಅ ವ ಳ ು	O
ಸತ್ತಿದ್ದರು ಸತ್ತಿದ್ದರು	ಸ ತ ್ ತ ಿ ದ ್ ದ ರ ು ಸ ತ ್ ತ ಿ ದ ್ ದ ರ ು	O
ತರಗು ತರಗು	ತ ರ ಗ ು ತ ರ ಗ ು	 LOC
ಪೂರ್ವ ಪೂರ್ವ	ಪ ೂ ರ ್ ವ ಪ ೂ ರ ್ ವ	B-LOC
ಲಿಂಗ ಲಿಂಗ	ಲ ಿ ಂ ಗ ಲ ಿ ಂ ಗ	O
ಶೀಘ್ರದಲ್ಲೇ ಶೀಘ್ರದಲ್ಲೇ	ಶ ೀ ಘ ್ ರ ದ ಲ ್ ಲ ೇ ಶ ೀ ಘ ್ ರ ದ ಲ ್ ಲ ೇ	O
ಸಂಬಂಧಪಟ್ಟವನು ಸಂಬಂಧಪಟ್ಟವನು	ಸ ಂ ಬ ಂ ಧ ಪ ಟ ್ ಟ ವ ನ ು ಸ ಂ ಬ ಂ ಧ ಪ ಟ ್ ಟ ವ ನ ು	O
	
. .	. .	O
ಚುನಾವಣೆಗಳಲ್ಲಿ ಚುನಾವಣೆಗಳಲ್ಲಿ	ಚ ು ನ ಾ ವ ಣ ೆ ಗ ಳ ಲ ್ ಲ ಿ ಚ ು ನ ಾ ವ ಣ ೆ ಗ ಳ ಲ ್ ಲ ಿ	O
. .	. .	O
ಅಪೇಕ್ಷೆಯನ್ನು ಅಪೇಕ್ಷೆಯನ್ನು	ಅ ಪ ೇ ಕ ್ ಷ ೆ ಯ ನ ್ ನ ು ಅ ಪ ೇ ಕ ್ ಷ ೆ ಯ ನ ್ ನ ು	O
ವಾಟೆರ್ಲು ವಾಟೆರ್ಲು	ವ ಾ ಟ ೆ ರ ್ ಲ ು ವ ಾ ಟ ೆ ರ ್ ಲ ು	O
ಮಗನೇ ಮಗನೇ	ಮ ಗ ನ ೇ ಮ ಗ ನ ೇ	B-ROL
ಕನೋಜ್ ಕನೋಜ್	ಕ ನ ೋ ಜ ್ ಕ ನ ೋ ಜ ್	B-LOC
ದಕ್ಷಿಣ ದಕ್ಷಿಣ	ದ ಕ ್ ಷ ಿ ಣ ದ ಕ ್ ಷ ಿ ಣ	O
ಮೊದಲ ಮೊದಲ	ಮ ೊ ದ ಲ ಮ ೊ ದ ಲ	O
. .	. .	O
ಜೀವನಶೈಲಿಗಳಬಗ್ಗೆ ಜೀವನಶೈಲಿಗಳಬಗ್ಗೆ	ಜ ೀ ವ ನ ಶ ೈ ಲ ಿ ಗ ಳ ಬ ಗ ್ ಗ ೆ ಜ ೀ ವ ನ ಶ ೈ ಲ ಿ ಗ ಳ ಬ ಗ ್ ಗ ೆ	O
	
ಔರಂಗಜೇಬನ ಔರಂಗಜೇಬನ	ಔ ರ ಂ ಗ ಜ ೇ ಬ ನ ಔ ರ ಂ ಗ ಜ ೇ ಬ ನ	B-PER
, ,	, ,	O
ಪುತ್ರಿಯರನ್ನು ಪುತ್ರಿಯರನ್ನು	ಪ ು ತ ್ ರ ಿ ಯ ರ ನ ್ ನ ು ಪ ು ತ ್ ರ ಿ ಯ ರ ನ ್ ನ ು	B-ROL
ಏಕೀಕರಣವೇ ಏಕೀಕರಣವೇ	ಏ ಕ ೀ ಕ ರ ಣ ವ ೇ ಏ ಕ ೀ ಕ ರ ಣ ವ ೇ	O
ಮೊಟ್ಟಮೊದಲು ಮೊಟ್ಟಮೊದಲು	ಮ ೊ ಟ ್ ಟ ಮ ೊ ದ ಲ ು ಮ ೊ ಟ ್ ಟ ಮ ೊ ದ ಲ ು	O
ಸಲ್ಲಿಸಿದರು ಸಲ್ಲಿಸಿದರು	ಸ ಲ ್ ಲ ಿ ಸ ಿ ದ ರ ು ಸ ಲ ್ ಲ ಿ ಸ ಿ ದ ರ ು	O
ಕನ್ನಡ ಕನ್ನಡ	ಕ ನ ್ ನ ಡ ಕ ನ ್ ನ ಡ	O
ಗದ್ವಾಲ ಗದ್ವಾಲ	ಗ ದ ್ ವ ಾ ಲ ಗ ದ ್ ವ ಾ ಲ	 LOC
ಅರಸರೆಂದರೆ ಅರಸರೆಂದರೆ	ಅ ರ ಸ ರ ೆ ಂ ದ ರ ೆ ಅ ರ ಸ ರ ೆ ಂ ದ ರ ೆ	B-ROL
ಮಹಾನ್ ಮಹಾನ್	ಮ ಹ ಾ ನ ್ ಮ ಹ ಾ ನ ್	O
. .	. .	O
	
, ,	, ,	O
ವ್ಯಕ್ತಿಯ ವ್ಯಕ್ತಿಯ	ವ ್ ಯ ಕ ್ ತ ಿ ಯ ವ ್ ಯ ಕ ್ ತ ಿ ಯ	O
ಪ್ರತಿಮೆ ಪ್ರತಿಮೆ	ಪ ್ ರ ತ ಿ ಮ ೆ ಪ ್ ರ ತ ಿ ಮ ೆ	O
. .	. .	O
	
ಕಿತ್ತೂರ ಕಿತ್ತೂರ	ಕ ಿ ತ ್ ತ ೂ ರ ಕ ಿ ತ ್ ತ ೂ ರ	B-LOC
ಮಾಡಲಾಯಿತು ಮಾಡಲಾಯಿತು	ಮ ಾ ಡ ಲ ಾ ಯ ಿ ತ ು ಮ ಾ ಡ ಲ ಾ ಯ ಿ ತ ು	O
	
ದಕ್ಷಿಣದಲ್ಲಿ ದಕ್ಷಿಣದಲ್ಲಿ	ದ ಕ ್ ಷ ಿ ಣ ದ ಲ ್ ಲ ಿ ದ ಕ ್ ಷ ಿ ಣ ದ ಲ ್ ಲ ಿ	 LOC
ಶಿರೂರುಯ ಶಿರೂರುಯ	ಶ ಿ ರ ೂ ರ ು ಯ ಶ ಿ ರ ೂ ರ ು ಯ	O
ಪತ್ನಿ ಪತ್ನಿ	ಪ ತ ್ ನ ಿ ಪ ತ ್ ನ ಿ	O
	
ಪರಿಪಾಲನೆಯ ಪರಿಪಾಲನೆಯ	ಪ ರ ಿ ಪ ಾ ಲ ನ ೆ ಯ ಪ ರ ಿ ಪ ಾ ಲ ನ ೆ ಯ	O
ನೈಟ್ಸ್ ನೈಟ್ಸ್	ನ ೆ ೖ ಟ ್ ಸ ್ ನ ೆ ೖ ಟ ್ ಸ ್	O
ಹಾಗೆಯೇ ಹಾಗೆಯೇ	ಹ ಾ ಗ ೆ ಯ ೇ ಹ ಾ ಗ ೆ ಯ ೇ	O
ರಾಜಕೀಯ ರಾಜಕೀಯ	ರ ಾ ಜ ಕ ೀ ಯ ರ ಾ ಜ ಕ ೀ ಯ	O
ಸ್ಥಿತಿಯಲ್ಲಿ ಸ್ಥಿತಿಯಲ್ಲಿ	ಸ ್ ಥ ಿ ತ ಿ ಯ ಲ ್ ಲ ಿ ಸ ್ ಥ ಿ ತ ಿ ಯ ಲ ್ ಲ ಿ	O
ಸಂಸ್ಕೃತಿ ಸಂಸ್ಕೃತಿ	ಸ ಂ ಸ ್ ಕ ೃ ತ ಿ ಸ ಂ ಸ ್ ಕ ೃ ತ ಿ	O
ಅವರು ಅವರು	ಅ ವ ರ ು ಅ ವ ರ ು	O
ವಿಜಯನಗರದ ವಿಜಯನಗರದ	ವ ಿ ಜ ಯ ನ ಗ ರ ದ ವ ಿ ಜ ಯ ನ ಗ ರ ದ	B-LOC
೧೦೦೦ದಷ್ಟು ೧೦೦೦ದಷ್ಟು	೧ ೦ ೦ ೦ ದ ಷ ್ ಟ ು
ಕವಲೇದುರ್ಗ ಕವಲೇದುರ್ಗ	ಕ ವ ಲ ೇ ದ ು ರ ್ ಗ ಕ ವ ಲ ೇ ದ ು ರ ್ ಗ	 LOC
ಸೋಲಿಸಿದನೆಂದೂ ಸೋಲಿಸಿದನೆಂದೂ	ಸ ೋ ಲ ಿ ಸ ಿ ದ ನ ೆ ಂ ದ ೂ ಸ ೋ ಲ ಿ ಸ ಿ ದ ನ ೆ ಂ ದ ೂ	O
ಯುನೈಟೆಡ್ ಯುನೈಟೆಡ್	ಯ ು ನ ೈ ಟ ೆ ಡ ್ ಯ ು ನ ೈ ಟ ೆ ಡ ್	B-LOC
	
ಇವರ ಇವರ	ಇ ವ ರ ಇ ವ ರ	O
ನಾಲ್ಕು ನಾಲ್ಕು	ನ ಾ ಲ ್ ಕ ು
ಪರಿಸ್ಥಿತಿಯಲ್ಲಿ ಪರಿಸ್ಥಿತಿಯಲ್ಲಿ	ಪ ರ ಿ ಸ ್ ಥ ಿ ತ ಿ ಯ ಲ ್ ಲ ಿ ಪ ರ ಿ ಸ ್ ಥ ಿ ತ ಿ ಯ ಲ ್ ಲ ಿ	O
	
ಶೈಲಿಯ ಶೈಲಿಯ	ಶ ೈ ಲ ಿ ಯ ಶ ೈ ಲ ಿ ಯ	O
ಗತ ಗತ	ಗ ತ ಗ ತ	O
, ,	, ,	O
ಅಧಿಕಾರಿಗಳು ಅಧಿಕಾರಿಗಳು	ಅ ಧ ಿ ಕ ಾ ರ ಿ ಗ ಳ ು ಅ ಧ ಿ ಕ ಾ ರ ಿ ಗ ಳ ು	O
. .	. .	O
ಬಂದಿತು ಬಂದಿತು	ಬ ಂ ದ ಿ ತ ು ಬ ಂ ದ ಿ ತ ು	O
ಅನೇಕರನ್ನು ಅನೇಕರನ್ನು	ಅ ನ ೇ ಕ ರ ನ ್ ನ ು ಅ ನ ೇ ಕ ರ ನ ್ ನ ು	O
ಗಾಂಧಿಯವರ ಗಾಂಧಿಯವರ	ಗ ಾ ಂ ಧ ಿ ಯ ವ ರ ಗ ಾ ಂ ಧ ಿ ಯ ವ ರ	B-PER
, ,	, ,	O
ಎದುರಿಸುವ ಎದುರಿಸುವ	ಎ ದ ು ರ ಿ ಸ ು ವ ಎ ದ ು ರ ಿ ಸ ು ವ	O
, ,	, ,	O
ಮದುವೆಯಾಗುವರು ಮದುವೆಯಾಗುವರು	ಮ ದ ು ವ ೆ ಯ ಾ ಗ ು ವ ರ ು ಮ ದ ು ವ ೆ ಯ ಾ ಗ ು ವ ರ ು	O
ಮೊಘಲ್ ಮೊಘಲ್	ಮ ೊ ಘ ಲ ್ ಮ ೊ ಘ ಲ ್	B-LOC
ಠಾಣೆ ಠಾಣೆ	ಠ ಾ ಣ ೆ ಠ ಾ ಣ ೆ	O
ಇವರ ಇವರ	ಇ ವ ರ ಇ ವ ರ	O
ಕಿ ಕಿ	ಕ ಿ ಕ ಿ	O
, ,	, ,	O
ನೆಲೆ ನೆಲೆ	ನ ೆ ಲ ೆ ನ ೆ ಲ ೆ	O
	
ಆತನ ಆತನ	ಆ ತ ನ ಆ ತ ನ	O
ತಕ್ಕ ತಕ್ಕ	ತ ಕ ್ ಕ ತ ಕ ್ ಕ	O
ಕೂದಲು ಕೂದಲು	ಕ ೂ ದ ಲ ು ಕ ೂ ದ ಲ ು	O
ಅತ್ಯಾಚಾರ ಅತ್ಯಾಚಾರ	ಅ ತ ್ ಯ ಾ ಚ ಾ ರ ಅ ತ ್ ಯ ಾ ಚ ಾ ರ	O
ಮೊದಲ ಮೊದಲ	ಮ ೊ ದ ಲ ಮ ೊ ದ ಲ	O
, ,	, ,	O
	
1000 1000	1 0 0 0 1 0 0 0	TME
ಇದು ಇದು	ಇ ದ ು ಇ ದ ು	O
ರಾಜಕುಮಾರರಲ್ಲಿ ರಾಜಕುಮಾರರಲ್ಲಿ	ರ ಾ ಜ ಕ ು ಮ ಾ ರ ರ ಲ ್ ಲ ಿ ರ ಾ ಜ ಕ ು ಮ ಾ ರ ರ ಲ ್ ಲ ಿ	B-ROL
, ,	, ,	O
ಅಂದಿನ ಅಂದಿನ	ಅ ಂ ದ ಿ ನ ಅ ಂ ದ ಿ ನ	O
ಭಾರತದ ಭಾರತದ	ಭ ಾ ರ ತ ದ ಭ ಾ ರ ತ ದ	B-LOC
ಗೋಡೆಯಲ್ಲಿದೆ ಗೋಡೆಯಲ್ಲಿದೆ	ಗ ೋ ಡ ೆ ಯ ಲ ್ ಲ ಿ ದ ೆ ಗ ೋ ಡ ೆ ಯ ಲ ್ ಲ ಿ ದ ೆ	O
ಭಾಷಾವಾರು ಭಾಷಾವಾರು	ಭ ಾ ಷ ಾ ವ ಾ ರ ು ಭ ಾ ಷ ಾ ವ ಾ ರ ು	O
ದಕ್ಷಿಣಕ್ಕೆ ದಕ್ಷಿಣಕ್ಕೆ	ದ ಕ ್ ಷ ಿ ಣ ಕ ್ ಕ ೆ ದ ಕ ್ ಷ ಿ ಣ ಕ ್ ಕ ೆ	O
ನಡುವೆಯೂ ನಡುವೆಯೂ	ನ ಡ ು ವ ೆ ಯ ೂ ನ ಡ ು ವ ೆ ಯ ೂ	O
ತನ್ನ ತನ್ನ	ತ ನ ್ ನ ತ ನ ್ ನ	O
ವ್ಯವಸ್ಥೆ ವ್ಯವಸ್ಥೆ	ವ ್ ಯ ವ ಸ ್ ಥ ೆ ವ ್ ಯ ವ ಸ ್ ಥ ೆ	O
ಸ್ಥಳ ಸ್ಥಳ	ಸ ್ ಥ ಳ ಸ ್ ಥ ಳ	O
ಉಪಯೋಗವಾದ ಉಪಯೋಗವಾದ	ಉ ಪ ಯ ೋ ಗ ವ ಾ ದ ಉ ಪ ಯ ೋ ಗ ವ ಾ ದ	O
ಅವ್ಯಾಹತವಾಗಿ ಅವ್ಯಾಹತವಾಗಿ	ಅ ವ ್ ಯ ಾ ಹ ತ ವ ಾ ಗ ಿ ಅ ವ ್ ಯ ಾ ಹ ತ ವ ಾ ಗ ಿ	O
ಹಳ್ಳಿಯ ಹಳ್ಳಿಯ	ಹ ಳ ್ ಳ ಿ ಯ ಹ ಳ ್ ಳ ಿ ಯ	O
ವಾರ್ಷಿಕ ವಾರ್ಷಿಕ	ವ ಾ ರ ್ ಷ ಿ ಕ ವ ಾ ರ ್ ಷ ಿ ಕ	O
ಸಂದಿಗ್ಧ ಸಂದಿಗ್ಧ	ಸ ಂ ದ ಿ ಗ ್ ಧ ಸ ಂ ದ ಿ ಗ ್ ಧ	O
ಎಂದು ಎಂದು	ಎ ಂ ದ ು ಎ ಂ ದ ು	O
ಹೋರಾಟದ ಹೋರಾಟದ	ಹ ೋ ರ ಾ ಟ ದ ಹ ೋ ರ ಾ ಟ ದ	O
ಸಮುದಾಯವನ್ನು ಸಮುದಾಯವನ್ನು	ಸ ಮ ು ದ ಾ ಯ ವ ನ ್ ನ ು ಸ ಮ ು ದ ಾ ಯ ವ ನ ್ ನ ು	ORG
ಐತಿಹಾಸಿಕ ಐತಿಹಾಸಿಕ	ಐ ತ ಿ ಹ ಾ ಸ ಿ ಕ ಐ ತ ಿ ಹ ಾ ಸ ಿ ಕ	O
ದೇವಾಲಯ ದೇವಾಲಯ	ದ ೇ ವ ಾ ಲ ಯ ದ ೇ ವ ಾ ಲ ಯ	 LOC
ಕಲ್ಲುಹಾಸಿನ ಕಲ್ಲುಹಾಸಿನ	ಕ ಲ ್ ಲ ು ಹ ಾ ಸ ಿ ನ ಕ ಲ ್ ಲ ು ಹ ಾ ಸ ಿ ನ	O
ಸಂದರ್ಭಗಳಲ್ಲಿ ಸಂದರ್ಭಗಳಲ್ಲಿ	ಸ ಂ ದ ರ ್ ಭ ಗ ಳ ಲ ್ ಲ ಿ ಸ ಂ ದ ರ ್ ಭ ಗ ಳ ಲ ್ ಲ ಿ	O
	
ತೋರಿಸುತ್ತಾ ತೋರಿಸುತ್ತಾ	ತ ೋ ರ ಿ ಸ ು ತ ್ ತ ಾ ತ ೋ ರ ಿ ಸ ು ತ ್ ತ ಾ	O
ಬೆಳವಣಿಗೆಗಳು ಬೆಳವಣಿಗೆಗಳು	ಬ ೆ ಳ ವ ಣ ಿ ಗ ೆ ಗ ಳ ು ಬ ೆ ಳ ವ ಣ ಿ ಗ ೆ ಗ ಳ ು	O
ಬೆಹರೆ ಬೆಹರೆ	ಬ ೆ ಹ ರ ೆ ಬ ೆ ಹ ರ ೆ	 PER
ಮಹಾಮಂಟಪ ಮಹಾಮಂಟಪ	ಮ ಹ ಾ ಮ ಂ ಟ ಪ ಮ ಹ ಾ ಮ ಂ ಟ ಪ	O
ಸೋಲಿಸಿ ಸೋಲಿಸಿ	ಸ ೋ ಲ ಿ ಸ ಿ ಸ ೋ ಲ ಿ ಸ ಿ	O
ಅವನನ್ನು ಅವನನ್ನು	ಅ ವ ನ ನ ್ ನ ು ಅ ವ ನ ನ ್ ನ ು	O
	
ಮತದಾನದ ಮತದಾನದ	ಮ ತ ದ ಾ ನ ದ ಮ ತ ದ ಾ ನ ದ	O
ಸೈನ್ಯವೊಂದನ್ನು ಸೈನ್ಯವೊಂದನ್ನು	ಸ ೈ ನ ್ ಯ ವ ೊ ಂ ದ ನ ್ ನ ು ಸ ೈ ನ ್ ಯ ವ ೊ ಂ ದ ನ ್ ನ ು	O
ಮತ್ತು ಮತ್ತು	ಮ ತ ್ ತ ು ಮ ತ ್ ತ ು	O
ಆಗ ಆಗ	ಆ ಗ ಆ ಗ	O
	
4 4	4
ಇವುಗಳಲ್ಲಿ ಇವುಗಳಲ್ಲಿ	ಇ ವ ು ಗ ಳ ಲ ್ ಲ ಿ ಇ ವ ು ಗ ಳ ಲ ್ ಲ ಿ	O
ತಿಳಿಯುವುದು ತಿಳಿಯುವುದು	ತ ಿ ಳ ಿ ಯ ು ವ ು ದ ು ತ ಿ ಳ ಿ ಯ ು ವ ು ದ ು	O
ಅಮೂಲ್ಯವಾದ ಅಮೂಲ್ಯವಾದ	ಅ ಮ ೂ ಲ ್ ಯ ವ ಾ ದ ಅ ಮ ೂ ಲ ್ ಯ ವ ಾ ದ	O
ಷಿಯಾಂಗ್ ಷಿಯಾಂಗ್	ಷ ಿ ಯ ಾ ಂ ಗ ್ ಷ ಿ ಯ ಾ ಂ ಗ ್	 PER
ಒಂದು ಒಂದು	ಒ ಂ ದ ು
ಬಂಧುಗಳು ಬಂಧುಗಳು	ಬ ಂ ಧ ು ಗ ಳ ು ಬ ಂ ಧ ು ಗ ಳ ು	O
ಎನ್ನುವವರು ಎನ್ನುವವರು	ಎ ನ ್ ನ ು ವ ವ ರ ು ಎ ನ ್ ನ ು ವ ವ ರ ು	O
ವಿಶ್ರಾಂತಿ ವಿಶ್ರಾಂತಿ	ವ ಿ ಶ ್ ರ ಾ ಂ ತ ಿ ವ ಿ ಶ ್ ರ ಾ ಂ ತ ಿ	O
ಮೂರು ಮೂರು	ಮ ೂ ರ ು
ಕಿಟಕಿಗಳ ಕಿಟಕಿಗಳ	ಕ ಿ ಟ ಕ ಿ ಗ ಳ ಕ ಿ ಟ ಕ ಿ ಗ ಳ	O
, ,	, ,	O
ಇತರ ಇತರ	ಇ ತ ರ ಇ ತ ರ	O
ಸಂದರ್ಭದಲ್ಲಿ ಸಂದರ್ಭದಲ್ಲಿ	ಸ ಂ ದ ರ ್ ಭ ದ ಲ ್ ಲ ಿ ಸ ಂ ದ ರ ್ ಭ ದ ಲ ್ ಲ ಿ	O
	
ನಂದಿಸೇನ ನಂದಿಸೇನ	ನ ಂ ದ ಿ ಸ ೇ ನ ನ ಂ ದ ಿ ಸ ೇ ನ	 PER
ಪುನಃಪಡೆದರೆ ಪುನಃಪಡೆದರೆ	ಪ ು ನ ಃ ಪ ಡ ೆ ದ ರ ೆ ಪ ು ನ ಃ ಪ ಡ ೆ ದ ರ ೆ	O
ಇಲ್ಲ ಇಲ್ಲ	ಇ ಲ ್ ಲ ಇ ಲ ್ ಲ	O
ಹತ್ತಿಕ್ಕಲು ಹತ್ತಿಕ್ಕಲು	ಹ ತ ್ ತ ಿ ಕ ್ ಕ ಲ ು ಹ ತ ್ ತ ಿ ಕ ್ ಕ ಲ ು	O
	
ಚರಿತ್ರೆಯ ಚರಿತ್ರೆಯ	ಚ ರ ಿ ತ ್ ರ ೆ ಯ ಚ ರ ಿ ತ ್ ರ ೆ ಯ	O
ವರ್ನಗಳು ವರ್ನಗಳು	ವ ರ ್ ನ ಗ ಳ ು ವ ರ ್ ನ ಗ ಳ ು	O
ಪರೀಕ್ಷಿಸುವುದಾಗಲಿಲ್ಲ ಪರೀಕ್ಷಿಸುವುದಾಗಲಿಲ್ಲ	ಪ ರ ೀ ಕ ್ ಷ ಿ ಸ ು ವ ು ದ ಾ ಗ ಲ ಿ ಲ ್ ಲ ಪ ರ ೀ ಕ ್ ಷ ಿ ಸ ು ವ ು ದ ಾ ಗ ಲ ಿ ಲ ್ ಲ	O
೨ ೨	೨
. .	. .	O
	
. .	. .	O
ಪಂಜಾಬ್ನ ಪಂಜಾಬ್ನ	ಪ ಂ ಜ ಾ ಬ ್ ನ ಪ ಂ ಜ ಾ ಬ ್ ನ	B-LOC
ದೌರ್ಜನ್ಯ ದೌರ್ಜನ್ಯ	ದ ೌ ರ ್ ಜ ನ ್ ಯ ದ ೌ ರ ್ ಜ ನ ್ ಯ	O
ಹಿನ್ನೆಲೆಯಲ್ಲಿ ಹಿನ್ನೆಲೆಯಲ್ಲಿ	ಹ ಿ ನ ್ ನ ೆ ಲ ೆ ಯ ಲ ್ ಲ ಿ ಹ ಿ ನ ್ ನ ೆ ಲ ೆ ಯ ಲ ್ ಲ ಿ	O
ನಾಲ್ವಡಿ ನಾಲ್ವಡಿ	ನ ಾ ಲ ್ ವ ಡ ಿ ನ ಾ ಲ ್ ವ ಡ ಿ	B-PER
ತ್ಯಜಿಸುವ ತ್ಯಜಿಸುವ	ತ ್ ಯ ಜ ಿ ಸ ು ವ ತ ್ ಯ ಜ ಿ ಸ ು ವ	O
ಜಾತಕ ಜಾತಕ	ಜ ಾ ತ ಕ ಜ ಾ ತ ಕ	O
ವಾರ ವಾರ	ವ ಾ ರ ವ ಾ ರ	O
ಬಿಡಲಾಗುತ್ತಿತು ಬಿಡಲಾಗುತ್ತಿತು	ಬ ಿ ಡ ಲ ಾ ಗ ು ತ ್ ತ ಿ ತ ು ಬ ಿ ಡ ಲ ಾ ಗ ು ತ ್ ತ ಿ ತ ು	O
ನಿರಂಕುಶ ನಿರಂಕುಶ	ನ ಿ ರ ಂ ಕ ು ಶ ನ ಿ ರ ಂ ಕ ು ಶ	O
ರಾಜಧರ್ಮವಾಯಿತು ರಾಜಧರ್ಮವಾಯಿತು	ರ ಾ ಜ ಧ ರ ್ ಮ ವ ಾ ಯ ಿ ತ ು ರ ಾ ಜ ಧ ರ ್ ಮ ವ ಾ ಯ ಿ ತ ು	O
ಇತಿಹಾಸವು ಇತಿಹಾಸವು	ಇ ತ ಿ ಹ ಾ ಸ ವ ು ಇ ತ ಿ ಹ ಾ ಸ ವ ು	O
ಹಕ್ಕನ್ನು ಹಕ್ಕನ್ನು	ಹ ಕ ್ ಕ ನ ್ ನ ು ಹ ಕ ್ ಕ ನ ್ ನ ು	O
	
ದಾಯಾದಿ ದಾಯಾದಿ	ದ ಾ ಯ ಾ ದ ಿ ದ ಾ ಯ ಾ ದ ಿ	O
ಪರ್ಷಿಯನ್ ಪರ್ಷಿಯನ್	ಪ ರ ್ ಷ ಿ ಯ ನ ್ ಪ ರ ್ ಷ ಿ ಯ ನ ್	O
ಸೋರಿಹೋಗುವ ಸೋರಿಹೋಗುವ	ಸ ೋ ರ ಿ ಹ ೋ ಗ ು ವ ಸ ೋ ರ ಿ ಹ ೋ ಗ ು ವ	O
ಕೃತಿಯನ್ನು ಕೃತಿಯನ್ನು	ಕ ೃ ತ ಿ ಯ ನ ್ ನ ು ಕ ೃ ತ ಿ ಯ ನ ್ ನ ು	O
ಕಲ್ಪಿಸುವಂತೆ ಕಲ್ಪಿಸುವಂತೆ	ಕ ಲ ್ ಪ ಿ ಸ ು ವ ಂ ತ ೆ ಕ ಲ ್ ಪ ಿ ಸ ು ವ ಂ ತ ೆ	O
ಬೇಟೆಗೆ ಬೇಟೆಗೆ	ಬ ೇ ಟ ೆ ಗ ೆ ಬ ೇ ಟ ೆ ಗ ೆ	O
ವಿಜಯನಗರ ವಿಜಯನಗರ	ವ ಿ ಜ ಯ ನ ಗ ರ ವ ಿ ಜ ಯ ನ ಗ ರ	B-LOC
ಮುಂದಾಯಿತು ಮುಂದಾಯಿತು	ಮ ು ಂ ದ ಾ ಯ ಿ ತ ು ಮ ು ಂ ದ ಾ ಯ ಿ ತ ು	O
ಮಾಡಿದ ಮಾಡಿದ	ಮ ಾ ಡ ಿ ದ ಮ ಾ ಡ ಿ ದ	O
ಚುನಾವಣೆ ಚುನಾವಣೆ	ಚ ು ನ ಾ ವ ಣ ೆ ಚ ು ನ ಾ ವ ಣ ೆ	O
1906ರಲ್ಲಿ 1906ರಲ್ಲಿ	1 9 0 6 ರ ಲ ್ ಲ ಿ
ರಾಜ್ಯಕ್ಕೆ ರಾಜ್ಯಕ್ಕೆ	ರ ಾ ಜ ್ ಯ ಕ ್ ಕ ೆ ರ ಾ ಜ ್ ಯ ಕ ್ ಕ ೆ	O
ಆಧುನಿಕ ಆಧುನಿಕ	ಆ ಧ ು ನ ಿ ಕ ಆ ಧ ು ನ ಿ ಕ	O
ಅಂದರೆ ಅಂದರೆ	ಅ ಂ ದ ರ ೆ ಅ ಂ ದ ರ ೆ	O
ಹಲವು ಹಲವು	ಹ ಲ ವ ು ಹ ಲ ವ ು	O
ಪೇಶ್ವೆಯರಿಗೆ ಪೇಶ್ವೆಯರಿಗೆ	ಪ ೇ ಶ ್ ವ ೆ ಯ ರ ಿ ಗ ೆ ಪ ೇ ಶ ್ ವ ೆ ಯ ರ ಿ ಗ ೆ	B-COM
ಸತ್ತವನ ಸತ್ತವನ	ಸ ತ ್ ತ ವ ನ ಸ ತ ್ ತ ವ ನ	O
. .	. .	O
ನೆರವು ನೆರವು	ನ ೆ ರ ವ ು ನ ೆ ರ ವ ು	O
ರಾಜ್ಯಗಳನ್ನು ರಾಜ್ಯಗಳನ್ನು	ರ ಾ ಜ ್ ಯ ಗ ಳ ನ ್ ನ ು ರ ಾ ಜ ್ ಯ ಗ ಳ ನ ್ ನ ು	O
ಎಂಬ ಎಂಬ	ಎ ಂ ಬ ಎ ಂ ಬ	O
	
ಕೃಷ್ಣಾಪು ಕೃಷ್ಣಾಪು	ಕ ೃ ಷ ್ ಣ ಾ ಪ ು ಕ ೃ ಷ ್ ಣ ಾ ಪ ು	B-COM
ಕಲಚುರಿ ಕಲಚುರಿ	ಕ ಲ ಚ ು ರ ಿ ಕ ಲ ಚ ು ರ ಿ	B-PER
. .	. .	O
ಕಿ ಕಿ	ಕ ಿ ಕ ಿ	O
ರಫ್ತು ರಫ್ತು	ರ ಫ ್ ತ ು ರ ಫ ್ ತ ು	O
ಸುದೀರ್ಘ ಸುದೀರ್ಘ	ಸ ು ದ ೀ ರ ್ ಘ ಸ ು ದ ೀ ರ ್ ಘ	O
ಇಲ್ಲಿಯೇ ಇಲ್ಲಿಯೇ	ಇ ಲ ್ ಲ ಿ ಯ ೇ ಇ ಲ ್ ಲ ಿ ಯ ೇ	O
ದುಂದುಮಿ ದುಂದುಮಿ	ದ ು ಂ ದ ು ಮ ಿ ದ ು ಂ ದ ು ಮ ಿ	O
ಮತ್ತು ಮತ್ತು	ಮ ತ ್ ತ ು ಮ ತ ್ ತ ು	O
ಮುಷ್ಕರಗಳನ್ನು ಮುಷ್ಕರಗಳನ್ನು	ಮ ು ಷ ್ ಕ ರ ಗ ಳ ನ ್ ನ ು ಮ ು ಷ ್ ಕ ರ ಗ ಳ ನ ್ ನ ು	O
, ,	, ,	O
ರಾಯಣ್ಣ ರಾಯಣ್ಣ	ರ ಾ ಯ ಣ ್ ಣ ರ ಾ ಯ ಣ ್ ಣ	B-PER
ಉಪನದಿಗಳು ಉಪನದಿಗಳು	ಉ ಪ ನ ದ ಿ ಗ ಳ ು ಉ ಪ ನ ದ ಿ ಗ ಳ ು	O
ನವಾಬರು ನವಾಬರು	ನ ವ ಾ ಬ ರ ು ನ ವ ಾ ಬ ರ ು	B-COM
ಆಯ್ಕೆ ಆಯ್ಕೆ	ಆ ಯ ್ ಕ ೆ ಆ ಯ ್ ಕ ೆ	O
. .	. .	O
	
ಕಲ್ಪಿಸಲಾಗಿತ್ತು ಕಲ್ಪಿಸಲಾಗಿತ್ತು	ಕ ಲ ್ ಪ ಿ ಸ ಲ ಾ ಗ ಿ ತ ್ ತ ು ಕ ಲ ್ ಪ ಿ ಸ ಲ ಾ ಗ ಿ ತ ್ ತ ು	O
ಇತರ ಇತರ	ಇ ತ ರ ಇ ತ ರ	O
ತಿಲಕ್ ತಿಲಕ್	ತ ಿ ಲ ಕ ್ ತ ಿ ಲ ಕ ್	 PER
ದಫ್ತರ್ ದಫ್ತರ್	ದ ಫ ್ ತ ರ ್ ದ ಫ ್ ತ ರ ್	O
ಗೊತ್ತುವಳಿಗಳನ್ನು ಗೊತ್ತುವಳಿಗಳನ್ನು	ಗ ೊ ತ ್ ತ ು ವ ಳ ಿ ಗ ಳ ನ ್ ನ ು ಗ ೊ ತ ್ ತ ು ವ ಳ ಿ ಗ ಳ ನ ್ ನ ು	O
ಮತ್ತು ಮತ್ತು	ಮ ತ ್ ತ ು ಮ ತ ್ ತ ು	O
	
ಶಿವಮೊಗ್ಗ ಶಿವಮೊಗ್ಗ	ಶ ಿ ವ ಮ ೊ ಗ ್ ಗ ಶ ಿ ವ ಮ ೊ ಗ ್ ಗ	 LOC
ಬಣವನ್ನು ಬಣವನ್ನು	ಬ ಣ ವ ನ ್ ನ ು ಬ ಣ ವ ನ ್ ನ ು	O
. .	. .	O
ರೌಲತ್ ರೌಲತ್	ರ ೌ ಲ ತ ್ ರ ೌ ಲ ತ ್	O
ಸಲ್ಲಿಸಲಾಗುತ್ತಿತ್ತು ಸಲ್ಲಿಸಲಾಗುತ್ತಿತ್ತು	ಸ ಲ ್ ಲ ಿ ಸ ಲ ಾ ಗ ು ತ ್ ತ ಿ ತ ್ ತ ು ಸ ಲ ್ ಲ ಿ ಸ ಲ ಾ ಗ ು ತ ್ ತ ಿ ತ ್ ತ ು	O
	
ಪಡೆದುಕೊಳ್ಳುವವರೆಗೆ ಪಡೆದುಕೊಳ್ಳುವವರೆಗೆ	ಪ ಡ ೆ ದ ು ಕ ೊ ಳ ್ ಳ ು ವ ವ ರ ೆ ಗ ೆ ಪ ಡ ೆ ದ ು ಕ ೊ ಳ ್ ಳ ು ವ ವ ರ ೆ ಗ ೆ	O
ಇನ್ನೊಂದು ಇನ್ನೊಂದು	ಇ ನ ್ ನ ೊ ಂ ದ ು ಇ ನ ್ ನ ೊ ಂ ದ ು	O
ದಿನಗಳಲ್ಲಿ ದಿನಗಳಲ್ಲಿ	ದ ಿ ನ ಗ ಳ ಲ ್ ಲ ಿ ದ ಿ ನ ಗ ಳ ಲ ್ ಲ ಿ	O
ಯುದ್ಧಗಳನ್ನು ಯುದ್ಧಗಳನ್ನು	ಯ ು ದ ್ ಧ ಗ ಳ ನ ್ ನ ು ಯ ು ದ ್ ಧ ಗ ಳ ನ ್ ನ ು	O
	
ಈ ಈ	ಈ ಈ	O
. .	. .	O
ಹೊರತುಪಡಿಸಿ ಹೊರತುಪಡಿಸಿ	ಹ ೊ ರ ತ ು ಪ ಡ ಿ ಸ ಿ ಹ ೊ ರ ತ ು ಪ ಡ ಿ ಸ ಿ	O
ಶತೃಗಳನ್ನು ಶತೃಗಳನ್ನು	ಶ ತ ೃ ಗ ಳ ನ ್ ನ ು ಶ ತ ೃ ಗ ಳ ನ ್ ನ ು	O
ಮದುವೆಮಾಡಿದ ಮದುವೆಮಾಡಿದ	ಮ ದ ು ವ ೆ ಮ ಾ ಡ ಿ ದ ಮ ದ ು ವ ೆ ಮ ಾ ಡ ಿ ದ	O
ಕೊನೆಯ ಕೊನೆಯ	ಕ ೊ ನ ೆ ಯ ಕ ೊ ನ ೆ ಯ	O
. .	. .	O
ರಾಜ್ಯಮದದಿಂದ ರಾಜ್ಯಮದದಿಂದ	ರ ಾ ಜ ್ ಯ ಮ ದ ದ ಿ ಂ ದ ರ ಾ ಜ ್ ಯ ಮ ದ ದ ಿ ಂ ದ	O
ಚಳವಳಿ ಚಳವಳಿ	ಚ ಳ ವ ಳ ಿ ಚ ಳ ವ ಳ ಿ	O
ಅವಳೊ ಅವಳೊ	ಅ ವ ಳ ೊ ಅ ವ ಳ ೊ	O
ಹೊಸ ಹೊಸ	ಹ ೊ ಸ ಹ ೊ ಸ	O
ಗ್ರಂಥಾಲಯದಲ್ಲಿ ಗ್ರಂಥಾಲಯದಲ್ಲಿ	ಗ ್ ರ ಂ ಥ ಾ ಲ ಯ ದ ಲ ್ ಲ ಿ ಗ ್ ರ ಂ ಥ ಾ ಲ ಯ ದ ಲ ್ ಲ ಿ	O
ಬಂದ ಬಂದ	ಬ ಂ ದ ಬ ಂ ದ	O
ಮೇಲೆ ಮೇಲೆ	ಮ ೇ ಲ ೆ ಮ ೇ ಲ ೆ	O
ಪಡೆಯು ಪಡೆಯು	ಪ ಡ ೆ ಯ ು ಪ ಡ ೆ ಯ ು	O
. .	. .	O
	
ಬಹಿಷ್ಕಾರದ ಬಹಿಷ್ಕಾರದ	ಬ ಹ ಿ ಷ ್ ಕ ಾ ರ ದ ಬ ಹ ಿ ಷ ್ ಕ ಾ ರ ದ	O
ಭಿನ್ನಾಭಿಪ್ರಾಯಗಳನ್ನು ಭಿನ್ನಾಭಿಪ್ರಾಯಗಳನ್ನು	ಭ ಿ ನ ್ ನ ಾ ಭ ಿ ಪ ್ ರ ಾ ಯ ಗ ಳ ನ ್ ನ ು ಭ ಿ ನ ್ ನ ಾ ಭ ಿ ಪ ್ ರ ಾ ಯ ಗ ಳ ನ ್ ನ ು	O
	
ಕೇಂದ್ರ ಕೇಂದ್ರ	ಕ ೇ ಂ ದ ್ ರ ಕ ೇ ಂ ದ ್ ರ	O
ಒಳನೋಟವನ್ನೊದಗಿಸುತದೆ ಒಳನೋಟವನ್ನೊದಗಿಸುತದೆ	ಒ ಳ ನ ೋ ಟ ವ ನ ್ ನ ೊ ದ ಗ ಿ ಸ ು ತ ದ ೆ ಒ ಳ ನ ೋ ಟ ವ ನ ್ ನ ೊ ದ ಗ ಿ ಸ ು ತ ದ ೆ	O
. .	. .	O
ಹಿರಿಯಕ್ಕನಂತೆ ಹಿರಿಯಕ್ಕನಂತೆ	ಹ ಿ ರ ಿ ಯ ಕ ್ ಕ ನ ಂ ತ ೆ ಹ ಿ ರ ಿ ಯ ಕ ್ ಕ ನ ಂ ತ ೆ	O
ಪೂರ್ವಿಕ ಪೂರ್ವಿಕ	ಪ ೂ ರ ್ ವ ಿ ಕ ಪ ೂ ರ ್ ವ ಿ ಕ	O
ಚಾವುಂಡರಾಯನು ಚಾವುಂಡರಾಯನು	ಚ ಾ ವ ು ಂ ಡ ರ ಾ ಯ ನ ು ಚ ಾ ವ ು ಂ ಡ ರ ಾ ಯ ನ ು	B-PER
ಮತ್ತು ಮತ್ತು	ಮ ತ ್ ತ ು ಮ ತ ್ ತ ು	O
ಮತ್ತೊಂದು ಮತ್ತೊಂದು	ಮ ತ ್ ತ ೊ ಂ ದ ು ಮ ತ ್ ತ ೊ ಂ ದ ು	O
ಕರಾರು ಕರಾರು	ಕ ರ ಾ ರ ು ಕ ರ ಾ ರ ು	O
ಇದನ್ನು ಇದನ್ನು	ಇ ದ ನ ್ ನ ು ಇ ದ ನ ್ ನ ು	O
ಮಲಗಿದ್ದು ಮಲಗಿದ್ದು	ಮ ಲ ಗ ಿ ದ ್ ದ ು ಮ ಲ ಗ ಿ ದ ್ ದ ು	O
ಮುಗಿದಾಗ ಮುಗಿದಾಗ	ಮ ು ಗ ಿ ದ ಾ ಗ ಮ ು ಗ ಿ ದ ಾ ಗ	O
ರಿಂದ ರಿಂದ	ರ ಿ ಂ ದ ರ ಿ ಂ ದ	O
ಕಟ್ಟಿ ಕಟ್ಟಿ	ಕ ಟ ್ ಟ ಿ ಕ ಟ ್ ಟ ಿ	O
	
ಬೆಳೆಸಿದ ಬೆಳೆಸಿದ	ಬ ೆ ಳ ೆ ಸ ಿ ದ ಬ ೆ ಳ ೆ ಸ ಿ ದ	O
ಮುಳುಗಿದ್ದ ಮುಳುಗಿದ್ದ	ಮ ು ಳ ು ಗ ಿ ದ ್ ದ ಮ ು ಳ ು ಗ ಿ ದ ್ ದ	O
ವಾಸ್ತುಶಿಲ್ಪ ವಾಸ್ತುಶಿಲ್ಪ	ವ ಾ ಸ ್ ತ ು ಶ ಿ ಲ ್ ಪ ವ ಾ ಸ ್ ತ ು ಶ ಿ ಲ ್ ಪ	O
	
ಮೂಲಕ ಮೂಲಕ	ಮ ೂ ಲ ಕ ಮ ೂ ಲ ಕ	O
ಒಂದಾಗಿತ್ತು ಒಂದಾಗಿತ್ತು	ಒ ಂ ದ ಾ ಗ ಿ ತ ್ ತ ು
ನೀಶಿ ನೀಶಿ	ನ ೀ ಶ ಿ ನ ೀ ಶ ಿ	O
ಕಾಳಿ ಕಾಳಿ	ಕ ಾ ಳ ಿ ಕ ಾ ಳ ಿ	O
. .	. .	O
ಪೀಡಿತ ಪೀಡಿತ	ಪ ೀ ಡ ಿ ತ ಪ ೀ ಡ ಿ ತ	O
ರಾಷ್ಟ್ರಕೂಟರು ರಾಷ್ಟ್ರಕೂಟರು	ರ ಾ ಷ ್ ಟ ್ ರ ಕ ೂ ಟ ರ ು ರ ಾ ಷ ್ ಟ ್ ರ ಕ ೂ ಟ ರ ು	ORG
ಒಂದಾಗಿದ್ದು ಒಂದಾಗಿದ್ದು	ಒ ಂ ದ ಾ ಗ ಿ ದ ್ ದ ು ಒ ಂ ದ ಾ ಗ ಿ ದ ್ ದ ು	O
ಜಾತಿಗಳಾಗಿ ಜಾತಿಗಳಾಗಿ	ಜ ಾ ತ ಿ ಗ ಳ ಾ ಗ ಿ ಜ ಾ ತ ಿ ಗ ಳ ಾ ಗ ಿ	O
14 14	1 4
	
ಪ್ಲೇಟೊ ಪ್ಲೇಟೊ	ಪ ್ ಲ ೆ ೕ ಟ ೊ ಪ ್ ಲ ೆ ೕ ಟ ೊ	B-PER
. .	. .	O
ಕಲೋಸಿಯಮ್ ಕಲೋಸಿಯಮ್	ಕ ಲ ೋ ಸ ಿ ಯ ಮ ್ ಕ ಲ ೋ ಸ ಿ ಯ ಮ ್	B-LOC
ವರ್ಗ ವರ್ಗ	ವ ರ ್ ಗ ವ ರ ್ ಗ	O
ನಡೆಸುತ್ತಿದ್ದ ನಡೆಸುತ್ತಿದ್ದ	ನ ಡ ೆ ಸ ು ತ ್ ತ ಿ ದ ್ ದ ನ ಡ ೆ ಸ ು ತ ್ ತ ಿ ದ ್ ದ	O
ಮಹಾನ್ ಮಹಾನ್	ಮ ಹ ಾ ನ ್ ಮ ಹ ಾ ನ ್	O
ದೊಡ್ಡ ದೊಡ್ಡ	ದ ೊ ಡ ್ ಡ ದ ೊ ಡ ್ ಡ	O
ಕಲ್ಯಾಣವನ್ನು ಕಲ್ಯಾಣವನ್ನು	ಕ ಲ ್ ಯ ಾ ಣ ವ ನ ್ ನ ು ಕ ಲ ್ ಯ ಾ ಣ ವ ನ ್ ನ ು	B-LOC
ಮರುಭೂಮಿಯಲ್ಲಿ ಮರುಭೂಮಿಯಲ್ಲಿ	ಮ ರ ು ಭ ೂ ಮ ಿ ಯ ಲ ್ ಲ ಿ ಮ ರ ು ಭ ೂ ಮ ಿ ಯ ಲ ್ ಲ ಿ	 LOC
ಒಂದು ಒಂದು	ಒ ಂ ದ ು ಒ ಂ ದ ು	O
, ,	, ,	O
ಸೊನ್ನೆಯನ್ನು ಸೊನ್ನೆಯನ್ನು	ಸ ೊ ನ ್ ನ ೆ ಯ ನ ್ ನ ು
ಬಳಸಲಾಗಿದೆ ಬಳಸಲಾಗಿದೆ	ಬ ಳ ಸ ಲ ಾ ಗ ಿ ದ ೆ ಬ ಳ ಸ ಲ ಾ ಗ ಿ ದ ೆ	O
ದೇವಾಲಯಗಳನ್ನು ದೇವಾಲಯಗಳನ್ನು	ದ ೇ ವ ಾ ಲ ಯ ಗ ಳ ನ ್ ನ ು ದ ೇ ವ ಾ ಲ ಯ ಗ ಳ ನ ್ ನ ು	O
ಹೊಂದಿದ್ದ ಹೊಂದಿದ್ದ	ಹ ೊ ಂ ದ ಿ ದ ್ ದ ಹ ೊ ಂ ದ ಿ ದ ್ ದ	O
ಸಹಕಾರದೊಂದಿಗೆ ಸಹಕಾರದೊಂದಿಗೆ	ಸ ಹ ಕ ಾ ರ ದ ೊ ಂ ದ ಿ ಗ ೆ ಸ ಹ ಕ ಾ ರ ದ ೊ ಂ ದ ಿ ಗ ೆ	B-ROL
ಅದರಲ್ಲಿ ಅದರಲ್ಲಿ	ಅ ದ ರ ಲ ್ ಲ ಿ ಅ ದ ರ ಲ ್ ಲ ಿ	O
ಇನ್ನೊಂದು ಇನ್ನೊಂದು	ಇ ನ ್ ನ ೊ ಂ ದ ು ಇ ನ ್ ನ ೊ ಂ ದ ು	O
ಜಯ ಜಯ	ಜ ಯ ಜ ಯ	O
ಜಪಾನ್ ಜಪಾನ್	ಜ ಪ ಾ ನ ್ ಜ ಪ ಾ ನ ್	B-LOC
	
ಭಾಗಗಳಾದ ಭಾಗಗಳಾದ	ಭ ಾ ಗ ಗ ಳ ಾ ದ ಭ ಾ ಗ ಗ ಳ ಾ ದ	O
. .	. .	O
ಪಲ್ಲವ ಪಲ್ಲವ	ಪ ಲ ್ ಲ ವ ಪ ಲ ್ ಲ ವ	B-COM
. .	. .	O
ಚಿಗುರೊಡೆದದ್ದು ಚಿಗುರೊಡೆದದ್ದು	ಚ ಿ ಗ ು ರ ೊ ಡ ೆ ದ ದ ್ ದ ು ಚ ಿ ಗ ು ರ ೊ ಡ ೆ ದ ದ ್ ದ ು	O
ಸಬಾಸದ್ ಸಬಾಸದ್	ಸ ಬ ಾ ಸ ದ ್ ಸ ಬ ಾ ಸ ದ ್	O
ಅವಳಲ್ಲಿ ಅವಳಲ್ಲಿ	ಅ ವ ಳ ಲ ್ ಲ ಿ ಅ ವ ಳ ಲ ್ ಲ ಿ	O
ಮುಂದೇ ಮುಂದೇ	ಮ ು ಂ ದ ೇ ಮ ು ಂ ದ ೇ	O
ರಾಜ್ಯ ರಾಜ್ಯ	ರ ಾ ಜ ್ ಯ ರ ಾ ಜ ್ ಯ	O
ಸಮಸ್ಯೆಗಳ ಸಮಸ್ಯೆಗಳ	ಸ ಮ ಸ ್ ಯ ೆ ಗ ಳ ಸ ಮ ಸ ್ ಯ ೆ ಗ ಳ	O
ಅಲಹಾಬಾದ್ ಅಲಹಾಬಾದ್	ಅ ಲ ಹ ಾ ಬ ಾ ದ ್ ಅ ಲ ಹ ಾ ಬ ಾ ದ ್	B-LOC
. .	. .	O
ಬೆಂಕಿ ಬೆಂಕಿ	ಬ ೆ ಂ ಕ ಿ ಬ ೆ ಂ ಕ ಿ	O
ಶತಮಾನದ ಶತಮಾನದ	ಶ ತ ಮ ಾ ನ ದ ಶ ತ ಮ ಾ ನ ದ	O
ಶ ಶ	ಶ ಶ	TME
ಈ ಈ	ಈ ಈ	O
ಇದನ್ನು ಇದನ್ನು	ಇ ದ ನ ್ ನ ು ಇ ದ ನ ್ ನ ು	O
ಯನ್ನು ಯನ್ನು	ಯ ನ ್ ನ ು ಯ ನ ್ ನ ು	O
ಈ ಈ	ಈ ಈ	O
ಗೆಲ್ಲುತ್ತ ಗೆಲ್ಲುತ್ತ	ಗ ೆ ಲ ್ ಲ ು ತ ್ ತ ಗ ೆ ಲ ್ ಲ ು ತ ್ ತ	O
ಶಾಂತಿ ಶಾಂತಿ	ಶ ಾ ಂ ತ ಿ ಶ ಾ ಂ ತ ಿ	O
ರಾಜಪ್ರಭುತ್ವವನ್ನೇ ರಾಜಪ್ರಭುತ್ವವನ್ನೇ	ರ ಾ ಜ ಪ ್ ರ ಭ ು ತ ್ ವ ವ ನ ್ ನ ೆ ೕ ರ ಾ ಜ ಪ ್ ರ ಭ ು ತ ್ ವ ವ ನ ್ ನ ೆ ೕ	O
ಅಂದು ಅಂದು	ಅ ಂ ದ ು ಅ ಂ ದ ು	O
ಯುದ್ಧ ಯುದ್ಧ	ಯ ು ದ ್ ಧ ಯ ು ದ ್ ಧ	O
ಸಕ್ರಿಯ ಸಕ್ರಿಯ	ಸ ಕ ್ ರ ಿ ಯ ಸ ಕ ್ ರ ಿ ಯ	O
	
, ,	, ,	O
ಗುಪ್ತಸಭೆಗಳನ್ನು ಗುಪ್ತಸಭೆಗಳನ್ನು	ಗ ು ಪ ್ ತ ಸ ಭ ೆ ಗ ಳ ನ ್ ನ ು ಗ ು ಪ ್ ತ ಸ ಭ ೆ ಗ ಳ ನ ್ ನ ು	O
ಪ್ರಪಂಚದ ಪ್ರಪಂಚದ	ಪ ್ ರ ಪ ಂ ಚ ದ ಪ ್ ರ ಪ ಂ ಚ ದ	O
ನಂಬುತ್ತಾರೆ ನಂಬುತ್ತಾರೆ	ನ ಂ ಬ ು ತ ್ ತ ಾ ರ ೆ ನ ಂ ಬ ು ತ ್ ತ ಾ ರ ೆ	O
ಮತ್ತೂ ಮತ್ತೂ	ಮ ತ ್ ತ ೂ ಮ ತ ್ ತ ೂ	O
	
ಎಲ್ಲವನ್ನೂ ಎಲ್ಲವನ್ನೂ	ಎ ಲ ್ ಲ ವ ನ ್ ನ ೂ ಎ ಲ ್ ಲ ವ ನ ್ ನ ೂ	O
ರಿಂದ ರಿಂದ	ರ ಿ ಂ ದ ರ ಿ ಂ ದ	O
ಗಳು ಗಳು	ಗ ಳ ು ಗ ಳ ು	O
ಹಟ್ಟಿಗಳನ್ನು ಹಟ್ಟಿಗಳನ್ನು	ಹ ಟ ್ ಟ ಿ ಗ ಳ ನ ್ ನ ು ಹ ಟ ್ ಟ ಿ ಗ ಳ ನ ್ ನ ು	O
ಪ್ರಾಂತ ಪ್ರಾಂತ	ಪ ್ ರ ಾ ಂ ತ ಪ ್ ರ ಾ ಂ ತ	O
ಶಿವಪ್ಪನಾಯಕನು ಶಿವಪ್ಪನಾಯಕನು	ಶ ಿ ವ ಪ ್ ಪ ನ ಾ ಯ ಕ ನ ು ಶ ಿ ವ ಪ ್ ಪ ನ ಾ ಯ ಕ ನ ು	B-PER
. .	. .	O
ಪಟ್ಟಕ್ಕೆ ಪಟ್ಟಕ್ಕೆ	ಪ ಟ ್ ಟ ಕ ್ ಕ ೆ ಪ ಟ ್ ಟ ಕ ್ ಕ ೆ	O
ಪೌರ ಪೌರ	ಪ ೌ ರ ಪ ೌ ರ	O
ಔರಂಗ್ಜೇಬ್ ಔರಂಗ್ಜೇಬ್	ಔ ರ ಂ ಗ ್ ಜ ೇ ಬ ್ ಔ ರ ಂ ಗ ್ ಜ ೇ ಬ ್	B-PER
ಬಾರಿ ಬಾರಿ	ಬ ಾ ರ ಿ ಬ ಾ ರ ಿ	O
ಪ್ರಸ್ತಾಪವಾಗದೆ ಪ್ರಸ್ತಾಪವಾಗದೆ	ಪ ್ ರ ಸ ್ ತ ಾ ಪ ವ ಾ ಗ ದ ೆ ಪ ್ ರ ಸ ್ ತ ಾ ಪ ವ ಾ ಗ ದ ೆ	O
ಜನರಿಟ್ಟ ಜನರಿಟ್ಟ	ಜ ನ ರ ಿ ಟ ್ ಟ ಜ ನ ರ ಿ ಟ ್ ಟ	O
ಮತ್ತು ಮತ್ತು	ಮ ತ ್ ತ ು ಮ ತ ್ ತ ು	O
ಹಿನ್ನೆಲೆಯಲ್ಲಿ ಹಿನ್ನೆಲೆಯಲ್ಲಿ	ಹ ಿ ನ ್ ನ ೆ ಲ ೆ ಯ ಲ ್ ಲ ಿ ಹ ಿ ನ ್ ನ ೆ ಲ ೆ ಯ ಲ ್ ಲ ಿ	O
130ರಿಂದ 130ರಿಂದ	1 3 0 ರ ಿ ಂ ದ
ಸೇರಿದಂತೆ ಸೇರಿದಂತೆ	ಸ ೇ ರ ಿ ದ ಂ ತ ೆ ಸ ೇ ರ ಿ ದ ಂ ತ ೆ	O
ಸನ್ಯಾಸಿಯ ಸನ್ಯಾಸಿಯ	ಸ ನ ್ ಯ ಾ ಸ ಿ ಯ ಸ ನ ್ ಯ ಾ ಸ ಿ ಯ	O
ಕಲಿಸಿದಿರಿ ಕಲಿಸಿದಿರಿ	ಕ ಲ ಿ ಸ ಿ ದ ಿ ರ ಿ ಕ ಲ ಿ ಸ ಿ ದ ಿ ರ ಿ	O
ರಚನೆಯಾಯಿತು ರಚನೆಯಾಯಿತು	ರ ಚ ನ ೆ ಯ ಾ ಯ ಿ ತ ು ರ ಚ ನ ೆ ಯ ಾ ಯ ಿ ತ ು	O
	
ಕೊನೆಗೊಂಡಿತು ಕೊನೆಗೊಂಡಿತು	ಕ ೊ ನ ೆ ಗ ೊ ಂ ಡ ಿ ತ ು ಕ ೊ ನ ೆ ಗ ೊ ಂ ಡ ಿ ತ ು	O
. .	. .	O
. .	. .	O
ಈ ಈ	ಈ ಈ	O
ಅವರು ಅವರು	ಅ ವ ರ ು ಅ ವ ರ ು	O
ಮೇಲೆ ಮೇಲೆ	ಮ ೇ ಲ ೆ ಮ ೇ ಲ ೆ	O
ಹಾತೊರೆಯುತ್ತಿದ್ದರು ಹಾತೊರೆಯುತ್ತಿದ್ದರು	ಹ ಾ ತ ೊ ರ ೆ ಯ ು ತ ್ ತ ಿ ದ ್ ದ ರ ು ಹ ಾ ತ ೊ ರ ೆ ಯ ು ತ ್ ತ ಿ ದ ್ ದ ರ ು	O
. .	. .	O
ಸರ್ಕಾರವು ಸರ್ಕಾರವು	ಸ ರ ್ ಕ ಾ ರ ವ ು ಸ ರ ್ ಕ ಾ ರ ವ ು	ORG
. .	. .	O
ಒಬ್ಬನಾದ ಒಬ್ಬನಾದ	ಒ ಬ ್ ಬ ನ ಾ ದ ಒ ಬ ್ ಬ ನ ಾ ದ	O
ಭಾರತದ ಭಾರತದ	ಭ ಾ ರ ತ ದ ಭ ಾ ರ ತ ದ	B-LOC
ಶತಮಾನದಲ್ಲಿ ಶತಮಾನದಲ್ಲಿ	ಶ ತ ಮ ಾ ನ ದ ಲ ್ ಲ ಿ ಶ ತ ಮ ಾ ನ ದ ಲ ್ ಲ ಿ	O
ಧೈರ್ಯ ಧೈರ್ಯ	ಧ ೈ ರ ್ ಯ ಧ ೈ ರ ್ ಯ	O
ಮುಂದೆ ಮುಂದೆ	ಮ ು ಂ ದ ೆ ಮ ು ಂ ದ ೆ	O
ಇದು ಇದು	ಇ ದ ು ಇ ದ ು	O
ಮಾಡಿತು ಮಾಡಿತು	ಮ ಾ ಡ ಿ ತ ು ಮ ಾ ಡ ಿ ತ ು	O
ವನ್ನು ವನ್ನು	ವ ನ ್ ನ ು ವ ನ ್ ನ ು	O
ಕೂಡಿದ ಕೂಡಿದ	ಕ ೂ ಡ ಿ ದ ಕ ೂ ಡ ಿ ದ	O
ಗದಗ ಗದಗ	ಗ ದ ಗ ಗ ದ ಗ	 LOC
	
ಪಾತ್ರ ಪಾತ್ರ	ಪ ಾ ತ ್ ರ ಪ ಾ ತ ್ ರ	O
ಮಾಹಿತಿಯನ್ನು ಮಾಹಿತಿಯನ್ನು	ಮ ಾ ಹ ಿ ತ ಿ ಯ ನ ್ ನ ು ಮ ಾ ಹ ಿ ತ ಿ ಯ ನ ್ ನ ು	O
ಮಲಬಾರ್ ಮಲಬಾರ್	ಮ ಲ ಬ ಾ ರ ್ ಮ ಲ ಬ ಾ ರ ್	B-LOC
ರಾಜರುಗಳನ್ನು ರಾಜರುಗಳನ್ನು	ರ ಾ ಜ ರ ು ಗ ಳ ನ ್ ನ ು ರ ಾ ಜ ರ ು ಗ ಳ ನ ್ ನ ು	B-ROL
	
ಅರಸರ ಅರಸರ	ಅ ರ ಸ ರ ಅ ರ ಸ ರ	B-ROL
ದೇವಾಲಯಕ್ಕೂ ದೇವಾಲಯಕ್ಕೂ	ದ ೇ ವ ಾ ಲ ಯ ಕ ್ ಕ ೂ ದ ೇ ವ ಾ ಲ ಯ ಕ ್ ಕ ೂ	O
ಮೀರ್ ಮೀರ್	ಮ ೀ ರ ್ ಮ ೀ ರ ್	B-PER
ಗರ್ಭಗುಡಿಯಲ್ಲಿ ಗರ್ಭಗುಡಿಯಲ್ಲಿ	ಗ ರ ್ ಭ ಗ ು ಡ ಿ ಯ ಲ ್ ಲ ಿ ಗ ರ ್ ಭ ಗ ು ಡ ಿ ಯ ಲ ್ ಲ ಿ	O
ಅಧಿಕಾರವು ಅಧಿಕಾರವು	ಅ ಧ ಿ ಕ ಾ ರ ವ ು ಅ ಧ ಿ ಕ ಾ ರ ವ ು	O
, ,	, ,	O
ವಿಫಲವಾದ ವಿಫಲವಾದ	ವ ಿ ಫ ಲ ವ ಾ ದ ವ ಿ ಫ ಲ ವ ಾ ದ	O
ದಂತಿದುರ್ಗನು ದಂತಿದುರ್ಗನು	ದ ಂ ತ ಿ ದ ು ರ ್ ಗ ನ ು ದ ಂ ತ ಿ ದ ು ರ ್ ಗ ನ ು	B-PER
ಸಿಂಹಾಸನ ಸಿಂಹಾಸನ	ಸ ಿ ಂ ಹ ಾ ಸ ನ ಸ ಿ ಂ ಹ ಾ ಸ ನ	O
. .	. .	O
ಇಂಥ ಇಂಥ	ಇ ಂ ಥ ಇ ಂ ಥ	O
ಗುರುನಾನಕ್ ಗುರುನಾನಕ್	ಗ ು ರ ು ನ ಾ ನ ಕ ್ ಗ ು ರ ು ನ ಾ ನ ಕ ್	B-PER
ಬಹಳ ಬಹಳ	ಬ ಹ ಳ ಬ ಹ ಳ	O
ಪ್ರಾರ್ಥಿಸಿ ಪ್ರಾರ್ಥಿಸಿ	ಪ ್ ರ ಾ ರ ್ ಥ ಿ ಸ ಿ ಪ ್ ರ ಾ ರ ್ ಥ ಿ ಸ ಿ	O
ಒಂದು ಒಂದು	ಒ ಂ ದ ು ಒ ಂ ದ ು	O
. .	. .	O
೪೦೦ ೪೦೦	೪ ೦ ೦
ವ್ಯಕ್ತಿಯಾಗಿದ್ದಾನೆ ವ್ಯಕ್ತಿಯಾಗಿದ್ದಾನೆ	ವ ್ ಯ ಕ ್ ತ ಿ ಯ ಾ ಗ ಿ ದ ್ ದ ಾ ನ ೆ ವ ್ ಯ ಕ ್ ತ ಿ ಯ ಾ ಗ ಿ ದ ್ ದ ಾ ನ ೆ	O
ಭೇರುಂಡೇಶ್ವರ ಭೇರುಂಡೇಶ್ವರ	ಭ ೇ ರ ು ಂ ಡ ೇ ಶ ್ ವ ರ ಭ ೇ ರ ು ಂ ಡ ೇ ಶ ್ ವ ರ	O
ರೀತಿಯಲ್ಲಿ ರೀತಿಯಲ್ಲಿ	ರ ೀ ತ ಿ ಯ ಲ ್ ಲ ಿ ರ ೀ ತ ಿ ಯ ಲ ್ ಲ ಿ	O
ಸಾರ್ವಭೌಮತ್ವವನ್ನು ಸಾರ್ವಭೌಮತ್ವವನ್ನು	ಸ ಾ ರ ್ ವ ಭ ೌ ಮ ತ ್ ವ ವ ನ ್ ನ ು ಸ ಾ ರ ್ ವ ಭ ೌ ಮ ತ ್ ವ ವ ನ ್ ನ ು	O
ಅರಸಿ ಅರಸಿ	ಅ ರ ಸ ಿ ಅ ರ ಸ ಿ	O
ರಾಷ್ಟ್ರಕೂಟರ ರಾಷ್ಟ್ರಕೂಟರ	ರ ಾ ಷ ್ ಟ ್ ರ ಕ ೂ ಟ ರ ರ ಾ ಷ ್ ಟ ್ ರ ಕ ೂ ಟ ರ	B-COM
ಅನೇಕ ಅನೇಕ	ಅ ನ ೇ ಕ ಅ ನ ೇ ಕ	O
ಟಿಪ್ಪುವಿನ ಟಿಪ್ಪುವಿನ	ಟ ಿ ಪ ್ ಪ ು ವ ಿ ನ ಟ ಿ ಪ ್ ಪ ು ವ ಿ ನ	 PER
ಎಂದು ಎಂದು	ಎ ಂ ದ ು ಎ ಂ ದ ು	O
ಕಾರಣರಾದರು ಕಾರಣರಾದರು	ಕ ಾ ರ ಣ ರ ಾ ದ ರ ು ಕ ಾ ರ ಣ ರ ಾ ದ ರ ು	O
ವಿರುದ್ಧ ವಿರುದ್ಧ	ವ ಿ ರ ು ದ ್ ಧ ವ ಿ ರ ು ದ ್ ಧ	O
ವಾಘ ವಾಘ	ವ ಾ ಘ ವ ಾ ಘ	 PER
ಕಾಲಚಕ್ರವೆಂದೂ ಕಾಲಚಕ್ರವೆಂದೂ	ಕ ಾ ಲ ಚ ಕ ್ ರ ವ ೆ ಂ ದ ೂ ಕ ಾ ಲ ಚ ಕ ್ ರ ವ ೆ ಂ ದ ೂ	O
. .	. .	O
ನಿರ್ಮಿಸಿಕೊಂಡರು ನಿರ್ಮಿಸಿಕೊಂಡರು	ನ ಿ ರ ್ ಮ ಿ ಸ ಿ ಕ ೊ ಂ ಡ ರ ು ನ ಿ ರ ್ ಮ ಿ ಸ ಿ ಕ ೊ ಂ ಡ ರ ು	O
ಶಿವ ಶಿವ	ಶ ಿ ವ ಶ ಿ ವ	B-PER
ನಿರೀಕ್ಷಕರುಗಳು ನಿರೀಕ್ಷಕರುಗಳು	ನ ಿ ರ ೀ ಕ ್ ಷ ಕ ರ ು ಗ ಳ ು ನ ಿ ರ ೀ ಕ ್ ಷ ಕ ರ ು ಗ ಳ ು	B-ROL
ದುಂಡು ದುಂಡು	ದ ು ಂ ಡ ು ದ ು ಂ ಡ ು	O
	
ಇಕ್ಕಟ್ಟಿನ ಇಕ್ಕಟ್ಟಿನ	ಇ ಕ ್ ಕ ಟ ್ ಟ ಿ ನ ಇ ಕ ್ ಕ ಟ ್ ಟ ಿ ನ	O
ಕೋಟೆ ಕೋಟೆ	ಕ ೋ ಟ ೆ ಕ ೋ ಟ ೆ	O
ತನ್ನ ತನ್ನ	ತ ನ ್ ನ ತ ನ ್ ನ	O
ಕೆಳಗಿನ ಕೆಳಗಿನ	ಕ ೆ ಳ ಗ ಿ ನ ಕ ೆ ಳ ಗ ಿ ನ	O
ಪುರೋಹಿತರೆನಿಸಿ ಪುರೋಹಿತರೆನಿಸಿ	ಪ ು ರ ೋ ಹ ಿ ತ ರ ೆ ನ ಿ ಸ ಿ ಪ ು ರ ೋ ಹ ಿ ತ ರ ೆ ನ ಿ ಸ ಿ	O
ಸಾಧಿಸಿದುದಕ್ಕೆ ಸಾಧಿಸಿದುದಕ್ಕೆ	ಸ ಾ ಧ ಿ ಸ ಿ ದ ು ದ ಕ ್ ಕ ೆ ಸ ಾ ಧ ಿ ಸ ಿ ದ ು ದ ಕ ್ ಕ ೆ	O
ಹಲಗಲಿ ಹಲಗಲಿ	ಹ ಲ ಗ ಲ ಿ ಹ ಲ ಗ ಲ ಿ	 LOC
ದುರಾದೃಷ್ಟ ದುರಾದೃಷ್ಟ	ದ ು ರ ಾ ದ ೃ ಷ ್ ಟ ದ ು ರ ಾ ದ ೃ ಷ ್ ಟ	O
, ,	, ,	O
ಎಸ್ ಎಸ್	ಎ ಸ ್ ಎ ಸ ್	O
ಅವುಗಳ ಅವುಗಳ	ಅ ವ ು ಗ ಳ ಅ ವ ು ಗ ಳ	O
ಅಧಿಕಾರಿ ಅಧಿಕಾರಿ	ಅ ಧ ಿ ಕ ಾ ರ ಿ ಅ ಧ ಿ ಕ ಾ ರ ಿ	B-ROL
. .	. .	O
ಚರ್ಚೆ ಚರ್ಚೆ	ಚ ರ ್ ಚ ೆ ಚ ರ ್ ಚ ೆ	O
ಹೆಚ್ಚು ಹೆಚ್ಚು	ಹ ೆ ಚ ್ ಚ ು ಹ ೆ ಚ ್ ಚ ು	O
ಬೆಟ್ಟ ಬೆಟ್ಟ	ಬ ೆ ಟ ್ ಟ ಬ ೆ ಟ ್ ಟ	O
, ,	, ,	O
ದುರಪಚಾರ ದುರಪಚಾರ	ದ ು ರ ಪ ಚ ಾ ರ ದ ು ರ ಪ ಚ ಾ ರ	O
೧೫೧೬ ೧೫೧೬	೧ ೫ ೧ ೬ ೧ ೫ ೧ ೬	TME
ಸೈನ್ವನ್ನು ಸೈನ್ವನ್ನು	ಸ ೈ ನ ್ ವ ನ ್ ನ ು ಸ ೈ ನ ್ ವ ನ ್ ನ ು	O
ಏನು ಏನು	ಏ ನ ು ಏ ನ ು	O
ಶಿಲ್ಪಕಲೆಯ ಶಿಲ್ಪಕಲೆಯ	ಶ ಿ ಲ ್ ಪ ಕ ಲ ೆ ಯ ಶ ಿ ಲ ್ ಪ ಕ ಲ ೆ ಯ	O
ಶ ಶ	ಶ ಶ	O
ಕಾನಿಷ್ಕನಾ ಕಾನಿಷ್ಕನಾ	ಕ ಾ ನ ಿ ಷ ್ ಕ ನ ಾ ಕ ಾ ನ ಿ ಷ ್ ಕ ನ ಾ	B-PER
, ,	, ,	O
ಇತರ ಇತರ	ಇ ತ ರ ಇ ತ ರ	O
ಅಂಚೆ ಅಂಚೆ	ಅ ಂ ಚ ೆ ಅ ಂ ಚ ೆ	O
ಬೀರಿದರೂ ಬೀರಿದರೂ	ಬ ೀ ರ ಿ ದ ರ ೂ ಬ ೀ ರ ಿ ದ ರ ೂ	O
	
ಮುಂದೆ ಮುಂದೆ	ಮ ು ಂ ದ ೆ ಮ ು ಂ ದ ೆ	O
ಶ್ರೀಪುರುಷಎರಡನೇ ಶ್ರೀಪುರುಷಎರಡನೇ	ಶ ್ ರ ೀ ಪ ು ರ ು ಷ ಎ ರ ಡ ನ ೇ ಶ ್ ರ ೀ ಪ ು ರ ು ಷ ಎ ರ ಡ ನ ೇ	B-PER
ಸಂಪತ್ತನ್ನು ಸಂಪತ್ತನ್ನು	ಸ ಂ ಪ ತ ್ ತ ನ ್ ನ ು ಸ ಂ ಪ ತ ್ ತ ನ ್ ನ ು	O
ಈ ಈ	ಈ ಈ	O
ಭಾರತೀಯ ಭಾರತೀಯ	ಭ ಾ ರ ತ ೀ ಯ ಭ ಾ ರ ತ ೀ ಯ	O
ಭಾರತೀಯ ಭಾರತೀಯ	ಭ ಾ ರ ತ ೀ ಯ ಭ ಾ ರ ತ ೀ ಯ	B-COM
ಬಹುಭಾಗ ಬಹುಭಾಗ	ಬ ಹ ು ಭ ಾ ಗ ಬ ಹ ು ಭ ಾ ಗ	O
ಸೋತ ಸೋತ	ಸ ೋ ತ ಸ ೋ ತ	O
ವೈಸ್ರಾಯಿಯಾಗಿದ್ದ ವೈಸ್ರಾಯಿಯಾಗಿದ್ದ	ವ ೈ ಸ ್ ರ ಾ ಯ ಿ ಯ ಾ ಗ ಿ ದ ್ ದ ವ ೈ ಸ ್ ರ ಾ ಯ ಿ ಯ ಾ ಗ ಿ ದ ್ ದ	B-ROL
ಶ ಶ	ಶ ಶ	TME
ನಾಗರಖಂಡ ನಾಗರಖಂಡ	ನ ಾ ಗ ರ ಖ ಂ ಡ ನ ಾ ಗ ರ ಖ ಂ ಡ	 LOC
ಇದೆ ಇದೆ	ಇ ದ ೆ ಇ ದ ೆ	O
ಎನ್ನುತ್ತಾರೆ ಎನ್ನುತ್ತಾರೆ	ಎ ನ ್ ನ ು ತ ್ ತ ಾ ರ ೆ ಎ ನ ್ ನ ು ತ ್ ತ ಾ ರ ೆ	O
	
ವಶಪಡಿಸಿಕ್ಕೊಳಲು ವಶಪಡಿಸಿಕ್ಕೊಳಲು	ವ ಶ ಪ ಡ ಿ ಸ ಿ ಕ ್ ಕ ೊ ಳ ಲ ು ವ ಶ ಪ ಡ ಿ ಸ ಿ ಕ ್ ಕ ೊ ಳ ಲ ು	O
ಅಂತರವಿದೆ ಅಂತರವಿದೆ	ಅ ಂ ತ ರ ವ ಿ ದ ೆ ಅ ಂ ತ ರ ವ ಿ ದ ೆ	O
ಅದು ಅದು	ಅ ದ ು ಅ ದ ು	O
ಒಬ್ಬನೇ ಒಬ್ಬನೇ	ಒ ಬ ್ ಬ ನ ೇ ಒ ಬ ್ ಬ ನ ೇ	O
ಧರ್ಮಗಳಲ್ಲಿ ಧರ್ಮಗಳಲ್ಲಿ	ಧ ರ ್ ಮ ಗ ಳ ಲ ್ ಲ ಿ ಧ ರ ್ ಮ ಗ ಳ ಲ ್ ಲ ಿ	O
ರಾಜ್ಯವನ್ನು ರಾಜ್ಯವನ್ನು	ರ ಾ ಜ ್ ಯ ವ ನ ್ ನ ು ರ ಾ ಜ ್ ಯ ವ ನ ್ ನ ು	O
. .	. .	O
ಶಾತಕರ್ಣಿಯ ಶಾತಕರ್ಣಿಯ	ಶ ಾ ತ ಕ ರ ್ ಣ ಿ ಯ ಶ ಾ ತ ಕ ರ ್ ಣ ಿ ಯ	 PER
ಇದಾಗಿತ್ತು ಇದಾಗಿತ್ತು	ಇ ದ ಾ ಗ ಿ ತ ್ ತ ು ಇ ದ ಾ ಗ ಿ ತ ್ ತ ು	O
ತಿಂಗಳಲ್ಲಿ ತಿಂಗಳಲ್ಲಿ	ತ ಿ ಂ ಗ ಳ ಲ ್ ಲ ಿ ತ ಿ ಂ ಗ ಳ ಲ ್ ಲ ಿ	O
ದೇವರಸನ ದೇವರಸನ	ದ ೇ ವ ರ ಸ ನ ದ ೇ ವ ರ ಸ ನ	 PER
ಜೊತೆಗೂಡಿ ಜೊತೆಗೂಡಿ	ಜ ೊ ತ ೆ ಗ ೂ ಡ ಿ ಜ ೊ ತ ೆ ಗ ೂ ಡ ಿ	O
. .	. .	O
ವಾಸಿಸಲು ವಾಸಿಸಲು	ವ ಾ ಸ ಿ ಸ ಲ ು ವ ಾ ಸ ಿ ಸ ಲ ು	O
ಮೊದಲು ಮೊದಲು	ಮ ೊ ದ ಲ ು ಮ ೊ ದ ಲ ು	O
೫೩ ೫೩	೫ ೩
1627 1627	1 6 2 7
ಪ್ರಶಂಸೆಯ ಪ್ರಶಂಸೆಯ	ಪ ್ ರ ಶ ಂ ಸ ೆ ಯ ಪ ್ ರ ಶ ಂ ಸ ೆ ಯ	O
ಅಲ್ಲಿ ಅಲ್ಲಿ	ಅ ಲ ್ ಲ ಿ ಅ ಲ ್ ಲ ಿ	O
ಅವರು ಅವರು	ಅ ವ ರ ು ಅ ವ ರ ು	O
, ,	, ,	O
ಕಡೆಯ ಕಡೆಯ	ಕ ಡ ೆ ಯ ಕ ಡ ೆ ಯ	O
ಜನತೆಯ ಜನತೆಯ	ಜ ನ ತ ೆ ಯ ಜ ನ ತ ೆ ಯ	O
ಭಯವಿತ್ತು ಭಯವಿತ್ತು	ಭ ಯ ವ ಿ ತ ್ ತ ು ಭ ಯ ವ ಿ ತ ್ ತ ು	O
ಸ್ವೀಕರಿಸಿದರು ಸ್ವೀಕರಿಸಿದರು	ಸ ್ ವ ಿ ೕ ಕ ರ ಿ ಸ ಿ ದ ರ ು ಸ ್ ವ ಿ ೕ ಕ ರ ಿ ಸ ಿ ದ ರ ು	O
ಭೂಮಿಯನ್ನು ಭೂಮಿಯನ್ನು	ಭ ೂ ಮ ಿ ಯ ನ ್ ನ ು ಭ ೂ ಮ ಿ ಯ ನ ್ ನ ು	O
. .	. .	O
ನೂರು ನೂರು	ನ ೂ ರ ು
ಕಂಡವು ಕಂಡವು	ಕ ಂ ಡ ವ ು ಕ ಂ ಡ ವ ು	O
ಮದ್ರಾಸನ್ನು ಮದ್ರಾಸನ್ನು	ಮ ದ ್ ರ ಾ ಸ ನ ್ ನ ು ಮ ದ ್ ರ ಾ ಸ ನ ್ ನ ು	B-LOC
ನಂತರ ನಂತರ	ನ ಂ ತ ರ ನ ಂ ತ ರ	O
. .	. .	O
ಎಂದು ಎಂದು	ಎ ಂ ದ ು ಎ ಂ ದ ು	O
ವರ್ಣಬೇಧವಿರಲಿಲ್ಲ ವರ್ಣಬೇಧವಿರಲಿಲ್ಲ	ವ ರ ್ ಣ ಬ ೇ ಧ ವ ಿ ರ ಲ ಿ ಲ ್ ಲ ವ ರ ್ ಣ ಬ ೇ ಧ ವ ಿ ರ ಲ ಿ ಲ ್ ಲ	O
ಕರ್ನಾಟಕ ಕರ್ನಾಟಕ	ಕ ರ ್ ನ ಾ ಟ ಕ ಕ ರ ್ ನ ಾ ಟ ಕ	O
ಕರ್ನಾಟಕದ ಕರ್ನಾಟಕದ	ಕ ರ ್ ನ ಾ ಟ ಕ ದ ಕ ರ ್ ನ ಾ ಟ ಕ ದ	B-LOC
ಈ ಈ	ಈ ಈ	O
	
ಕಿತ್ತೂರು ಕಿತ್ತೂರು	ಕ ಿ ತ ್ ತ ೂ ರ ು ಕ ಿ ತ ್ ತ ೂ ರ ು	B-LOC
ಕಿ ಕಿ	ಕ ಿ ಕ ಿ	O
ಭಾರತದ ಭಾರತದ	ಭ ಾ ರ ತ ದ ಭ ಾ ರ ತ ದ	B-LOC
ಕ್ರೂರ ಕ್ರೂರ	ಕ ್ ರ ೂ ರ ಕ ್ ರ ೂ ರ	O
	
ಸಮೀಪದ ಸಮೀಪದ	ಸ ಮ ೀ ಪ ದ ಸ ಮ ೀ ಪ ದ	O
ವಶವಾಯಿತು ವಶವಾಯಿತು	ವ ಶ ವ ಾ ಯ ಿ ತ ು ವ ಶ ವ ಾ ಯ ಿ ತ ು	O
ಅಡಗಿಸಲು ಅಡಗಿಸಲು	ಅ ಡ ಗ ಿ ಸ ಲ ು ಅ ಡ ಗ ಿ ಸ ಲ ು	O
೯ ೯	೯
ವಲಸೆ ವಲಸೆ	ವ ಲ ಸ ೆ ವ ಲ ಸ ೆ	O
ಧಾರ್ಮಿಕ ಧಾರ್ಮಿಕ	ಧ ಾ ರ ್ ಮ ಿ ಕ ಧ ಾ ರ ್ ಮ ಿ ಕ	O
ಸಮ್ಯಕ್ಜ್ಞಾನ ಸಮ್ಯಕ್ಜ್ಞಾನ	ಸ ಮ ್ ಯ ಕ ್ ಜ ್ ಞ ಾ ನ ಸ ಮ ್ ಯ ಕ ್ ಜ ್ ಞ ಾ ನ	O
. .	. .	O
ಶಾಸನಗಳು ಶಾಸನಗಳು	ಶ ಾ ಸ ನ ಗ ಳ ು ಶ ಾ ಸ ನ ಗ ಳ ು	O
ಕೇಂದ್ರಾಡಳಿತ ಕೇಂದ್ರಾಡಳಿತ	ಕ ೇ ಂ ದ ್ ರ ಾ ಡ ಳ ಿ ತ ಕ ೇ ಂ ದ ್ ರ ಾ ಡ ಳ ಿ ತ	O
ಮೊಟ್ಟಮೊದಲ ಮೊಟ್ಟಮೊದಲ	ಮ ೊ ಟ ್ ಟ ಮ ೊ ದ ಲ ಮ ೊ ಟ ್ ಟ ಮ ೊ ದ ಲ	O
ದಾಳಿ ದಾಳಿ	ದ ಾ ಳ ಿ ದ ಾ ಳ ಿ	O
. .	. .	O
	
ಕಾಲದ ಕಾಲದ	ಕ ಾ ಲ ದ ಕ ಾ ಲ ದ	O
ಮಠ ಮಠ	ಮ ಠ ಮ ಠ	O
ವಿಜಯನಗರ ವಿಜಯನಗರ	ವ ಿ ಜ ಯ ನ ಗ ರ ವ ಿ ಜ ಯ ನ ಗ ರ	ORG
ವಿದ್ಯಾಭ್ಯಾಸವನ್ನು ವಿದ್ಯಾಭ್ಯಾಸವನ್ನು	ವ ಿ ದ ್ ಯ ಾ ಭ ್ ಯ ಾ ಸ ವ ನ ್ ನ ು ವ ಿ ದ ್ ಯ ಾ ಭ ್ ಯ ಾ ಸ ವ ನ ್ ನ ು	O
. .	. .	O
ಜೀವನ ಜೀವನ	ಜ ೀ ವ ನ ಜ ೀ ವ ನ	O
ನಿಜಾಮ ನಿಜಾಮ	ನ ಿ ಜ ಾ ಮ ನ ಿ ಜ ಾ ಮ	B-PER
ನೆಲೆಸುವಂತೆ ನೆಲೆಸುವಂತೆ	ನ ೆ ಲ ೆ ಸ ು ವ ಂ ತ ೆ ನ ೆ ಲ ೆ ಸ ು ವ ಂ ತ ೆ	O
ಚೋಳಸೇನೆಯನ್ನು ಚೋಳಸೇನೆಯನ್ನು	ಚ ೋ ಳ ಸ ೇ ನ ೆ ಯ ನ ್ ನ ು ಚ ೋ ಳ ಸ ೇ ನ ೆ ಯ ನ ್ ನ ು	O
ಸಮಾಜ ಸಮಾಜ	ಸ ಮ ಾ ಜ ಸ ಮ ಾ ಜ	O
ಗರ್ಭಗೃಹದ ಗರ್ಭಗೃಹದ	ಗ ರ ್ ಭ ಗ ೃ ಹ ದ ಗ ರ ್ ಭ ಗ ೃ ಹ ದ	O
ಮುಂತಾದವು ಮುಂತಾದವು	ಮ ು ಂ ತ ಾ ದ ವ ು ಮ ು ಂ ತ ಾ ದ ವ ು	O
ಅತಿಥಿಗಳಿಗೆ ಅತಿಥಿಗಳಿಗೆ	ಅ ತ ಿ ಥ ಿ ಗ ಳ ಿ ಗ ೆ ಅ ತ ಿ ಥ ಿ ಗ ಳ ಿ ಗ ೆ	O
. .	. .	O
ಈಸ್ಟ್ ಈಸ್ಟ್	ಈ ಸ ್ ಟ ್ ಈ ಸ ್ ಟ ್	ORG
	
. .	. .	O
ಭಾಗ ಭಾಗ	ಭ ಾ ಗ ಭ ಾ ಗ	O
ಆತನಿಗೆ ಆತನಿಗೆ	ಆ ತ ನ ಿ ಗ ೆ ಆ ತ ನ ಿ ಗ ೆ	O
ಸಂಘರ್ಷದ ಸಂಘರ್ಷದ	ಸ ಂ ಘ ರ ್ ಷ ದ ಸ ಂ ಘ ರ ್ ಷ ದ	O
ದೊರೆಗಳನ್ನಾಗಿ ದೊರೆಗಳನ್ನಾಗಿ	ದ ೊ ರ ೆ ಗ ಳ ನ ್ ನ ಾ ಗ ಿ ದ ೊ ರ ೆ ಗ ಳ ನ ್ ನ ಾ ಗ ಿ	B-ROL
ಪರಿಕಲ್ಪನೆಗಳು ಪರಿಕಲ್ಪನೆಗಳು	ಪ ರ ಿ ಕ ಲ ್ ಪ ನ ೆ ಗ ಳ ು ಪ ರ ಿ ಕ ಲ ್ ಪ ನ ೆ ಗ ಳ ು	O
ಪ್ರಾಯಶಃ ಪ್ರಾಯಶಃ	ಪ ್ ರ ಾ ಯ ಶ ಃ ಪ ್ ರ ಾ ಯ ಶ ಃ	O
ಎಂ ಎಂ	ಎ ಂ ಎ ಂ	O
ಅರಸನಾದ ಅರಸನಾದ	ಅ ರ ಸ ನ ಾ ದ ಅ ರ ಸ ನ ಾ ದ	B-ROL
ಹೊಂದಿದೆ ಹೊಂದಿದೆ	ಹ ೊ ಂ ದ ಿ ದ ೆ ಹ ೊ ಂ ದ ಿ ದ ೆ	O
ಕನಸುಕಾಣುತ್ತಿದ್ದ ಕನಸುಕಾಣುತ್ತಿದ್ದ	ಕ ನ ಸ ು ಕ ಾ ಣ ು ತ ್ ತ ಿ ದ ್ ದ ಕ ನ ಸ ು ಕ ಾ ಣ ು ತ ್ ತ ಿ ದ ್ ದ	O
ಆ ಆ	ಆ ಆ	O
ಸತ್ಯಾಗ್ರಹ ಸತ್ಯಾಗ್ರಹ	ಸ ತ ್ ಯ ಾ ಗ ್ ರ ಹ ಸ ತ ್ ಯ ಾ ಗ ್ ರ ಹ	O
ಎ ಎ	ಎ ಎ	O
ತಯಾರಿದ್ದರೂ ತಯಾರಿದ್ದರೂ	ತ ಯ ಾ ರ ಿ ದ ್ ದ ರ ೂ ತ ಯ ಾ ರ ಿ ದ ್ ದ ರ ೂ	O
ಚಿನ್ನದ ಚಿನ್ನದ	ಚ ಿ ನ ್ ನ ದ ಚ ಿ ನ ್ ನ ದ	O
ಜೈನಬಸದಿಗಳು ಜೈನಬಸದಿಗಳು	ಜ ೈ ನ ಬ ಸ ದ ಿ ಗ ಳ ು ಜ ೈ ನ ಬ ಸ ದ ಿ ಗ ಳ ು	O
. .	. .	O
ಸಮಾಜವಾದಿ ಸಮಾಜವಾದಿ	ಸ ಮ ಾ ಜ ವ ಾ ದ ಿ ಸ ಮ ಾ ಜ ವ ಾ ದ ಿ	O
ಹಮ್ಮಿಕೊಂಡಿದ್ದ ಹಮ್ಮಿಕೊಂಡಿದ್ದ	ಹ ಮ ್ ಮ ಿ ಕ ೊ ಂ ಡ ಿ ದ ್ ದ ಹ ಮ ್ ಮ ಿ ಕ ೊ ಂ ಡ ಿ ದ ್ ದ	O
ಪ್ರಭಾವ ಪ್ರಭಾವ	ಪ ್ ರ ಭ ಾ ವ ಪ ್ ರ ಭ ಾ ವ	O
ಉದಯ್ ಉದಯ್	ಉ ದ ಯ ್ ಉ ದ ಯ ್	 PER
ಮತ್ತು ಮತ್ತು	ಮ ತ ್ ತ ು ಮ ತ ್ ತ ು	O
ಹೇಳುತ್ತಾ ಹೇಳುತ್ತಾ	ಹ ೇ ಳ ು ತ ್ ತ ಾ ಹ ೇ ಳ ು ತ ್ ತ ಾ	O
ಅಮೆರಿಕ ಅಮೆರಿಕ	ಅ ಮ ೆ ರ ಿ ಕ ಅ ಮ ೆ ರ ಿ ಕ	B-LOC
ಸ್ವಾತ್ರಂತ್ರ್ಯ ಸ್ವಾತ್ರಂತ್ರ್ಯ	ಸ ್ ವ ಾ ತ ್ ರ ಂ ತ ್ ರ ್ ಯ ಸ ್ ವ ಾ ತ ್ ರ ಂ ತ ್ ರ ್ ಯ	O
. .	. .	O
ಮನ್ನಣೆ ಮನ್ನಣೆ	ಮ ನ ್ ನ ಣ ೆ ಮ ನ ್ ನ ಣ ೆ	O
ಶಾಂತಿಪರಿಪಾಲನೆ ಶಾಂತಿಪರಿಪಾಲನೆ	ಶ ಾ ಂ ತ ಿ ಪ ರ ಿ ಪ ಾ ಲ ನ ೆ ಶ ಾ ಂ ತ ಿ ಪ ರ ಿ ಪ ಾ ಲ ನ ೆ	O
ವೈರಾಗ್ಯದಿಂದ ವೈರಾಗ್ಯದಿಂದ	ವ ೈ ರ ಾ ಗ ್ ಯ ದ ಿ ಂ ದ ವ ೈ ರ ಾ ಗ ್ ಯ ದ ಿ ಂ ದ	O
ವಿಕಾಸ ವಿಕಾಸ	ವ ಿ ಕ ಾ ಸ ವ ಿ ಕ ಾ ಸ	O
ಮುಖಂಡ಼ತ್ವದಲ್ಲಿದ್ದ ಮುಖಂಡ಼ತ್ವದಲ್ಲಿದ್ದ	ಮ ು ಖ ಂ ಡ ಼ ತ ್ ವ ದ ಲ ್ ಲ ಿ ದ ್ ದ ಮ ು ಖ ಂ ಡ ಼ ತ ್ ವ ದ ಲ ್ ಲ ಿ ದ ್ ದ	O
ಇಂಡೋ ಇಂಡೋ	ಇ ಂ ಡ ೋ ಇ ಂ ಡ ೋ	 LOC
ಸ್ಥಾನಮಾನ ಸ್ಥಾನಮಾನ	ಸ ್ ಥ ಾ ನ ಮ ಾ ನ ಸ ್ ಥ ಾ ನ ಮ ಾ ನ	O
ಗೆದ್ದಿದ್ದರು ಗೆದ್ದಿದ್ದರು	ಗ ೆ ದ ್ ದ ಿ ದ ್ ದ ರ ು ಗ ೆ ದ ್ ದ ಿ ದ ್ ದ ರ ು	O
ತರಗು ತರಗು	ತ ರ ಗ ು ತ ರ ಗ ು	 LOC
ಅಲ್ಲಿ ಅಲ್ಲಿ	ಅ ಲ ್ ಲ ಿ ಅ ಲ ್ ಲ ಿ	O
ರಾಷ್ಟ್ರೀಯ ರಾಷ್ಟ್ರೀಯ	ರ ಾ ಷ ್ ಟ ್ ರ ಿ ೕ ಯ ರ ಾ ಷ ್ ಟ ್ ರ ಿ ೕ ಯ	O
ಅಥವಾ ಅಥವಾ	ಅ ಥ ವ ಾ ಅ ಥ ವ ಾ	O
ಊರು ಊರು	ಊ ರ ು ಊ ರ ು	O
ಅದು ಅದು	ಅ ದ ು ಅ ದ ು	O
ದೋರೆಗಳಿಗೇ ದೋರೆಗಳಿಗೇ	ದ ೋ ರ ೆ ಗ ಳ ಿ ಗ ೇ ದ ೋ ರ ೆ ಗ ಳ ಿ ಗ ೇ	O
ಸಹ ಸಹ	ಸ ಹ ಸ ಹ	O
ಇದಕ್ಕೆ ಇದಕ್ಕೆ	ಇ ದ ಕ ್ ಕ ೆ ಇ ದ ಕ ್ ಕ ೆ	O
ಎಂಬ ಎಂಬ	ಎ ಂ ಬ ಎ ಂ ಬ	O
ಕೆತ್ತನೆಗೆ ಕೆತ್ತನೆಗೆ	ಕ ೆ ತ ್ ತ ನ ೆ ಗ ೆ ಕ ೆ ತ ್ ತ ನ ೆ ಗ ೆ	O
ಮಾಡಲಾಯಿತು ಮಾಡಲಾಯಿತು	ಮ ಾ ಡ ಲ ಾ ಯ ಿ ತ ು ಮ ಾ ಡ ಲ ಾ ಯ ಿ ತ ು	O
ಅಲಂಪೂರು ಅಲಂಪೂರು	ಅ ಲ ಂ ಪ ೂ ರ ು ಅ ಲ ಂ ಪ ೂ ರ ು	B-LOC
ಕೈಗೊಂಬೆಯಾಗಿದ್ದ ಕೈಗೊಂಬೆಯಾಗಿದ್ದ	ಕ ೈ ಗ ೊ ಂ ಬ ೆ ಯ ಾ ಗ ಿ ದ ್ ದ ಕ ೈ ಗ ೊ ಂ ಬ ೆ ಯ ಾ ಗ ಿ ದ ್ ದ	O
ಸಂವಿಧಾನ ಸಂವಿಧಾನ	ಸ ಂ ವ ಿ ಧ ಾ ನ ಸ ಂ ವ ಿ ಧ ಾ ನ	O
	
1948ರಂದು 1948ರಂದು	1 9 4 8 ರ ಂ ದ ು
ನಡೆಸಿದ ನಡೆಸಿದ	ನ ಡ ೆ ಸ ಿ ದ ನ ಡ ೆ ಸ ಿ ದ	O
ಪಶುಪಾಲನೆ ಪಶುಪಾಲನೆ	ಪ ಶ ು ಪ ಾ ಲ ನ ೆ ಪ ಶ ು ಪ ಾ ಲ ನ ೆ	O
ಮತ್ತು ಮತ್ತು	ಮ ತ ್ ತ ು ಮ ತ ್ ತ ು	O
ತೆರಿಗೆಯನ್ನುಸಂಗ್ರಹಿಸಿದರು ತೆರಿಗೆಯನ್ನುಸಂಗ್ರಹಿಸಿದರು	ತ ೆ ರ ಿ ಗ ೆ ಯ ನ ್ ನ ು ಸ ಂ ಗ ್ ರ ಹ ಿ ಸ ಿ ದ ರ ು ತ ೆ ರ ಿ ಗ ೆ ಯ ನ ್ ನ ು ಸ ಂ ಗ ್ ರ ಹ ಿ ಸ ಿ ದ ರ ು	O
	
ತಿಳಿದು ತಿಳಿದು	ತ ಿ ಳ ಿ ದ ು ತ ಿ ಳ ಿ ದ ು	O
ಅಥವಾ ಅಥವಾ	ಅ ಥ ವ ಾ ಅ ಥ ವ ಾ	O
ಆರ್ಥಿಕ ಆರ್ಥಿಕ	ಆ ರ ್ ಥ ಿ ಕ ಆ ರ ್ ಥ ಿ ಕ	O
ಶೋಷಣೆಗೆ ಶೋಷಣೆಗೆ	ಶ ೋ ಷ ಣ ೆ ಗ ೆ ಶ ೋ ಷ ಣ ೆ ಗ ೆ	O
ಹಗೆತನವನ್ನು ಹಗೆತನವನ್ನು	ಹ ಗ ೆ ತ ನ ವ ನ ್ ನ ು ಹ ಗ ೆ ತ ನ ವ ನ ್ ನ ು	O
ಸಂಭವನೀಯ ಸಂಭವನೀಯ	ಸ ಂ ಭ ವ ನ ೀ ಯ ಸ ಂ ಭ ವ ನ ೀ ಯ	O
. .	. .	O
ಯುದ್ಧನಷ್ಟ ಯುದ್ಧನಷ್ಟ	ಯ ು ದ ್ ಧ ನ ಷ ್ ಟ ಯ ು ದ ್ ಧ ನ ಷ ್ ಟ	O
ಭಂಗವಾಗುತ್ತಿದೆಯೆಂದು ಭಂಗವಾಗುತ್ತಿದೆಯೆಂದು	ಭ ಂ ಗ ವ ಾ ಗ ು ತ ್ ತ ಿ ದ ೆ ಯ ೆ ಂ ದ ು ಭ ಂ ಗ ವ ಾ ಗ ು ತ ್ ತ ಿ ದ ೆ ಯ ೆ ಂ ದ ು	O
	
ತಡೆಗೋಡೆ ತಡೆಗೋಡೆ	ತ ಡ ೆ ಗ ೋ ಡ ೆ ತ ಡ ೆ ಗ ೋ ಡ ೆ	O
ರಕ್ಷಣೆಯ ರಕ್ಷಣೆಯ	ರ ಕ ್ ಷ ಣ ೆ ಯ ರ ಕ ್ ಷ ಣ ೆ ಯ	O
ಸಂಪ್ರದಾಯಗಳನ್಩ು ಸಂಪ್ರದಾಯಗಳನ್಩ು	ಸ ಂ ಪ ್ ರ ದ ಾ ಯ ಗ ಳ ನ ್ ಩ ು ಸ ಂ ಪ ್ ರ ದ ಾ ಯ ಗ ಳ ನ ್ ಩ ು	O
ಅಧ್ಯಕ್ಷರಾಗಿ ಅಧ್ಯಕ್ಷರಾಗಿ	ಅ ಧ ್ ಯ ಕ ್ ಷ ರ ಾ ಗ ಿ ಅ ಧ ್ ಯ ಕ ್ ಷ ರ ಾ ಗ ಿ	B-ROL
ಪ್ರಯತ್ನಿಸಿದರು ಪ್ರಯತ್ನಿಸಿದರು	ಪ ್ ರ ಯ ತ ್ ನ ಿ ಸ ಿ ದ ರ ು ಪ ್ ರ ಯ ತ ್ ನ ಿ ಸ ಿ ದ ರ ು	O
ರಾಜಧಾನಿ ರಾಜಧಾನಿ	ರ ಾ ಜ ಧ ಾ ನ ಿ ರ ಾ ಜ ಧ ಾ ನ ಿ	O
ಸ್ವಾತಂತ್ರ್ಯಕ್ಕಾಗಿ ಸ್ವಾತಂತ್ರ್ಯಕ್ಕಾಗಿ	ಸ ್ ವ ಾ ತ ಂ ತ ್ ರ ್ ಯ ಕ ್ ಕ ಾ ಗ ಿ ಸ ್ ವ ಾ ತ ಂ ತ ್ ರ ್ ಯ ಕ ್ ಕ ಾ ಗ ಿ	O
ದಿವಾನಿ ದಿವಾನಿ	ದ ಿ ವ ಾ ನ ಿ ದ ಿ ವ ಾ ನ ಿ	O
	
. .	. .	O
. .	. .	O
ಜನರನ್ನು ಜನರನ್ನು	ಜ ನ ರ ನ ್ ನ ು ಜ ನ ರ ನ ್ ನ ು	O
ಮತು ಮತು	ಮ ತ ು ಮ ತ ು	O
ಅನೇಕ ಅನೇಕ	ಅ ನ ೇ ಕ ಅ ನ ೇ ಕ	O
	
ಅವರು ಅವರು	ಅ ವ ರ ು ಅ ವ ರ ು	O
. .	. .	O
ಸ್ವಲ್ಪ ಸ್ವಲ್ಪ	ಸ ್ ವ ಲ ್ ಪ ಸ ್ ವ ಲ ್ ಪ	O
, ,	, ,	O
. .	. .	O
	
ವ್ಯಾಪಾರ ವ್ಯಾಪಾರ	ವ ್ ಯ ಾ ಪ ಾ ರ ವ ್ ಯ ಾ ಪ ಾ ರ	O
ತನ್ನ ತನ್ನ	ತ ನ ್ ನ ತ ನ ್ ನ	O
ನಿರ್ಮಿಸಲಾಯಿತು ನಿರ್ಮಿಸಲಾಯಿತು	ನ ಿ ರ ್ ಮ ಿ ಸ ಲ ಾ ಯ ಿ ತ ು ನ ಿ ರ ್ ಮ ಿ ಸ ಲ ಾ ಯ ಿ ತ ು	O
ಅವರು ಅವರು	ಅ ವ ರ ು ಅ ವ ರ ು	O
	
1942 1942	1 9 4 2
	
ಯಾವುದೇ ಯಾವುದೇ	ಯ ಾ ವ ು ದ ೇ ಯ ಾ ವ ು ದ ೇ	O
ಪ್ರಾಂತ್ಯಗಳನ್ನು ಪ್ರಾಂತ್ಯಗಳನ್ನು	ಪ ್ ರ ಾ ಂ ತ ್ ಯ ಗ ಳ ನ ್ ನ ು ಪ ್ ರ ಾ ಂ ತ ್ ಯ ಗ ಳ ನ ್ ನ ು	O
ಒಂದನೆಯ ಒಂದನೆಯ	ಒ ಂ ದ ನ ೆ ಯ ಒ ಂ ದ ನ ೆ ಯ	B-PER
ರಾಣಿ ರಾಣಿ	ರ ಾ ಣ ಿ ರ ಾ ಣ ಿ	B-ROL
. .	. .	O
ರಣತಂತ್ರಕ್ಕೆ ರಣತಂತ್ರಕ್ಕೆ	ರ ಣ ತ ಂ ತ ್ ರ ಕ ್ ಕ ೆ ರ ಣ ತ ಂ ತ ್ ರ ಕ ್ ಕ ೆ	O
	
. .	. .	O
ಇಂದಿನ ಇಂದಿನ	ಇ ಂ ದ ಿ ನ ಇ ಂ ದ ಿ ನ	O
ವೆಂಕಟಪ್ಪನಾಯಕ ವೆಂಕಟಪ್ಪನಾಯಕ	ವ ೆ ಂ ಕ ಟ ಪ ್ ಪ ನ ಾ ಯ ಕ ವ ೆ ಂ ಕ ಟ ಪ ್ ಪ ನ ಾ ಯ ಕ	 PER
ಐಹೊಳೆಯ ಐಹೊಳೆಯ	ಐ ಹ ೊ ಳ ೆ ಯ ಐ ಹ ೊ ಳ ೆ ಯ	B-LOC
ವಿಧಾನಗಳನ್ನು ವಿಧಾನಗಳನ್ನು	ವ ಿ ಧ ಾ ನ ಗ ಳ ನ ್ ನ ು ವ ಿ ಧ ಾ ನ ಗ ಳ ನ ್ ನ ು	O
ಮನಮೋಹಕ ಮನಮೋಹಕ	ಮ ನ ಮ ೋ ಹ ಕ ಮ ನ ಮ ೋ ಹ ಕ	O
ಭಾರತದ ಭಾರತದ	ಭ ಾ ರ ತ ದ ಭ ಾ ರ ತ ದ	B-LOC
ಒಳಗೆ ಒಳಗೆ	ಒ ಳ ಗ ೆ ಒ ಳ ಗ ೆ	O
	
. .	. .	O
೧೮೧೮ ೧೮೧೮	೧ ೮ ೧ ೮ ೧ ೮ ೧ ೮	TME
ಪ್ರತಿಪಾದಿಸಿದರು ಪ್ರತಿಪಾದಿಸಿದರು	ಪ ್ ರ ತ ಿ ಪ ಾ ದ ಿ ಸ ಿ ದ ರ ು ಪ ್ ರ ತ ಿ ಪ ಾ ದ ಿ ಸ ಿ ದ ರ ು	O
ಶಾತವಾಹನ ಶಾತವಾಹನ	ಶ ಾ ತ ವ ಾ ಹ ನ ಶ ಾ ತ ವ ಾ ಹ ನ	B-COM
ವಿಶಾಕದತ್ತನ ವಿಶಾಕದತ್ತನ	ವ ಿ ಶ ಾ ಕ ದ ತ ್ ತ ನ ವ ಿ ಶ ಾ ಕ ದ ತ ್ ತ ನ	B-PER
ಸ್ವತಂತ್ರವಾಗಿ ಸ್ವತಂತ್ರವಾಗಿ	ಸ ್ ವ ತ ಂ ತ ್ ರ ವ ಾ ಗ ಿ ಸ ್ ವ ತ ಂ ತ ್ ರ ವ ಾ ಗ ಿ	O
ಒಳಪಡಿಸಿತು ಒಳಪಡಿಸಿತು	ಒ ಳ ಪ ಡ ಿ ಸ ಿ ತ ು ಒ ಳ ಪ ಡ ಿ ಸ ಿ ತ ು	O
ಒಳಪಟ್ಟಿದ್ದ ಒಳಪಟ್ಟಿದ್ದ	ಒ ಳ ಪ ಟ ್ ಟ ಿ ದ ್ ದ ಒ ಳ ಪ ಟ ್ ಟ ಿ ದ ್ ದ	O
ವಿಶಿಷ್ಟ ವಿಶಿಷ್ಟ	ವ ಿ ಶ ಿ ಷ ್ ಟ ವ ಿ ಶ ಿ ಷ ್ ಟ	O
ದಕ್ಷಿಣ ದಕ್ಷಿಣ	ದ ಕ ್ ಷ ಿ ಣ ದ ಕ ್ ಷ ಿ ಣ	 LOC
. .	. .	O
ಬಿಜಾಪುರ ಬಿಜಾಪುರ	ಬ ಿ ಜ ಾ ಪ ು ರ ಬ ಿ ಜ ಾ ಪ ು ರ	 LOC
ಓಡಿಸಿದನು ಓಡಿಸಿದನು	ಓ ಡ ಿ ಸ ಿ ದ ನ ು ಓ ಡ ಿ ಸ ಿ ದ ನ ು	O
ತುಕ್ಕು ತುಕ್ಕು	ತ ು ಕ ್ ಕ ು ತ ು ಕ ್ ಕ ು	O
ಜೀವಿಸಬಹುದಾಗಿದೆ ಜೀವಿಸಬಹುದಾಗಿದೆ	ಜ ೀ ವ ಿ ಸ ಬ ಹ ು ದ ಾ ಗ ಿ ದ ೆ ಜ ೀ ವ ಿ ಸ ಬ ಹ ು ದ ಾ ಗ ಿ ದ ೆ	O
ಆ ಆ	ಆ ಆ	O
	
. .	. .	O
ವಿಸ್ತರಿಸುತ್ತ ವಿಸ್ತರಿಸುತ್ತ	ವ ಿ ಸ ್ ತ ರ ಿ ಸ ು ತ ್ ತ ವ ಿ ಸ ್ ತ ರ ಿ ಸ ು ತ ್ ತ	O
ಅಶೋಕನು ಅಶೋಕನು	ಅ ಶ ೋ ಕ ನ ು ಅ ಶ ೋ ಕ ನ ು	B-PER
ಕಲೆ ಕಲೆ	ಕ ಲ ೆ ಕ ಲ ೆ	O
ಇವುಗಳಲ್ಲಿ ಇವುಗಳಲ್ಲಿ	ಇ ವ ು ಗ ಳ ಲ ್ ಲ ಿ ಇ ವ ು ಗ ಳ ಲ ್ ಲ ಿ	O
. .	. .	O
ಎರಡನೇ ಎರಡನೇ	ಎ ರ ಡ ನ ೇ ಎ ರ ಡ ನ ೇ	B-PER
ಗಾಂಧಿ ಗಾಂಧಿ	ಗ ಾ ಂ ಧ ಿ ಗ ಾ ಂ ಧ ಿ	B-PER
ಜಿಲ್ಲೆಗಳು ಜಿಲ್ಲೆಗಳು	ಜ ಿ ಲ ್ ಲ ೆ ಗ ಳ ು ಜ ಿ ಲ ್ ಲ ೆ ಗ ಳ ು	O
ಅರಸರು ಅರಸರು	ಅ ರ ಸ ರ ು ಅ ರ ಸ ರ ು	B-ROL
ಇತಿಹಾಸದ ಇತಿಹಾಸದ	ಇ ತ ಿ ಹ ಾ ಸ ದ ಇ ತ ಿ ಹ ಾ ಸ ದ	O
ಸಹೋದರರ ಸಹೋದರರ	ಸ ಹ ೋ ದ ರ ರ ಸ ಹ ೋ ದ ರ ರ	O
ನಡೆಸಿದ ನಡೆಸಿದ	ನ ಡ ೆ ಸ ಿ ದ ನ ಡ ೆ ಸ ಿ ದ	O
ಹೆಸರು ಹೆಸರು	ಹ ೆ ಸ ರ ು ಹ ೆ ಸ ರ ು	O
ವಿದೇಶಗಳಲ್ಲಿ ವಿದೇಶಗಳಲ್ಲಿ	ವ ಿ ದ ೇ ಶ ಗ ಳ ಲ ್ ಲ ಿ ವ ಿ ದ ೇ ಶ ಗ ಳ ಲ ್ ಲ ಿ	O
ತೋರುವುದು ತೋರುವುದು	ತ ೋ ರ ು ವ ು ದ ು ತ ೋ ರ ು ವ ು ದ ು	O
ರೈಸ್ ರೈಸ್	ರ ೈ ಸ ್ ರ ೈ ಸ ್	 PER
. .	. .	O
ವಿಶಾಲ ವಿಶಾಲ	ವ ಿ ಶ ಾ ಲ ವ ಿ ಶ ಾ ಲ	 PER
ತನ್ನ ತನ್ನ	ತ ನ ್ ನ ತ ನ ್ ನ	O
ನ ನ	ನ ನ	O
ನಡೆಯದೆ ನಡೆಯದೆ	ನ ಡ ೆ ಯ ದ ೆ ನ ಡ ೆ ಯ ದ ೆ	O
	
	
ಸೇರಿದರು ಸೇರಿದರು	ಸ ೇ ರ ಿ ದ ರ ು ಸ ೇ ರ ಿ ದ ರ ು	O
ನಡುವೆ ನಡುವೆ	ನ ಡ ು ವ ೆ ನ ಡ ು ವ ೆ	O
ಸ್ಥಳದಲ್ಲಿ ಸ್ಥಳದಲ್ಲಿ	ಸ ್ ಥ ಳ ದ ಲ ್ ಲ ಿ ಸ ್ ಥ ಳ ದ ಲ ್ ಲ ಿ	O
ಬಹುಮುಖ್ಯ ಬಹುಮುಖ್ಯ	ಬ ಹ ು ಮ ು ಖ ್ ಯ ಬ ಹ ು ಮ ು ಖ ್ ಯ	O
ವಿಷ್ಣುವಿನ ವಿಷ್ಣುವಿನ	ವ ಿ ಷ ್ ಣ ು ವ ಿ ನ ವ ಿ ಷ ್ ಣ ು ವ ಿ ನ	B-PER
ಪ್ರೋತ್ಸಾಹ ಪ್ರೋತ್ಸಾಹ	ಪ ್ ರ ೊ ೕ ತ ್ ಸ ಾ ಹ ಪ ್ ರ ೊ ೕ ತ ್ ಸ ಾ ಹ	O
ಬೆಳವಣಿಗೆಯನ್ನು ಬೆಳವಣಿಗೆಯನ್ನು	ಬ ೆ ಳ ವ ಣ ಿ ಗ ೆ ಯ ನ ್ ನ ು ಬ ೆ ಳ ವ ಣ ಿ ಗ ೆ ಯ ನ ್ ನ ು	O
. .	. .	O
	
ಕೋಳಿ ಕೋಳಿ	ಕ ೋ ಳ ಿ ಕ ೋ ಳ ಿ	O
ಬರೆಯುವ ಬರೆಯುವ	ಬ ರ ೆ ಯ ು ವ ಬ ರ ೆ ಯ ು ವ	O
ಬರಿದಾಗಿತ್ತು ಬರಿದಾಗಿತ್ತು	ಬ ರ ಿ ದ ಾ ಗ ಿ ತ ್ ತ ು ಬ ರ ಿ ದ ಾ ಗ ಿ ತ ್ ತ ು	O
ದೆಹಲಿ ದೆಹಲಿ	ದ ೆ ಹ ಲ ಿ ದ ೆ ಹ ಲ ಿ	B-LOC
ಬರೆದ ಬರೆದ	ಬ ರ ೆ ದ ಬ ರ ೆ ದ	O
೨೨ ೨೨	೨ ೨
ಪಿ ಪಿ	ಪ ಿ ಪ ಿ	B-PER
ಮೊಘಲ್ ಮೊಘಲ್	ಮ ೊ ಘ ಲ ್ ಮ ೊ ಘ ಲ ್	B-COM
ಸಲ್ಲಿಸಿದ ಸಲ್ಲಿಸಿದ	ಸ ಲ ್ ಲ ಿ ಸ ಿ ದ ಸ ಲ ್ ಲ ಿ ಸ ಿ ದ	O
ಒಪ್ಪಂದ ಒಪ್ಪಂದ	ಒ ಪ ್ ಪ ಂ ದ ಒ ಪ ್ ಪ ಂ ದ	O
	
ಹಾಗೂ ಹಾಗೂ	ಹ ಾ ಗ ೂ ಹ ಾ ಗ ೂ	O
, ,	, ,	O
ನೈಪುಣ್ಯತೆಗೆ ನೈಪುಣ್ಯತೆಗೆ	ನ ೈ ಪ ು ಣ ್ ಯ ತ ೆ ಗ ೆ ನ ೈ ಪ ು ಣ ್ ಯ ತ ೆ ಗ ೆ	O
ಬೆಲೆಯ ಬೆಲೆಯ	ಬ ೆ ಲ ೆ ಯ ಬ ೆ ಲ ೆ ಯ	O
	
ಮೇಲೆ ಮೇಲೆ	ಮ ೇ ಲ ೆ ಮ ೇ ಲ ೆ	O
ಬ್ರಿಟೀಷರಿಗೆ ಬ್ರಿಟೀಷರಿಗೆ	ಬ ್ ರ ಿ ಟ ೀ ಷ ರ ಿ ಗ ೆ ಬ ್ ರ ಿ ಟ ೀ ಷ ರ ಿ ಗ ೆ	B-COM
ಚಮದ್ರಗುಪ್ತಮೌರ್ಯನು ಚಮದ್ರಗುಪ್ತಮೌರ್ಯನು	ಚ ಮ ದ ್ ರ ಗ ು ಪ ್ ತ ಮ ೌ ರ ್ ಯ ನ ು ಚ ಮ ದ ್ ರ ಗ ು ಪ ್ ತ ಮ ೌ ರ ್ ಯ ನ ು	B-PER
ಸರ್ಕಾರವು ಸರ್ಕಾರವು	ಸ ರ ್ ಕ ಾ ರ ವ ು ಸ ರ ್ ಕ ಾ ರ ವ ು	ORG
	
ಕಾರಣನಾದ ಕಾರಣನಾದ	ಕ ಾ ರ ಣ ನ ಾ ದ ಕ ಾ ರ ಣ ನ ಾ ದ	O
೧೯೧೯ ೧೯೧೯	೧ ೯ ೧ ೯ ೧ ೯ ೧ ೯	TME
, ,	, ,	O
ಫೋರ್ಟ್ ಫೋರ್ಟ್	ಫ ೋ ರ ್ ಟ ್ ಫ ೋ ರ ್ ಟ ್	B-PER
ಸೂಫಿ ಸೂಫಿ	ಸ ೂ ಫ ಿ ಸ ೂ ಫ ಿ	I-COM
ಅಕ್ಬರ ಅಕ್ಬರ	ಅ ಕ ್ ಬ ರ ಅ ಕ ್ ಬ ರ	B-PER
ಅವರ ಅವರ	ಅ ವ ರ ಅ ವ ರ	O
, ,	, ,	O
ಮೂರ್ತಿಪೂಜೆ ಮೂರ್ತಿಪೂಜೆ	ಮ ೂ ರ ್ ತ ಿ ಪ ೂ ಜ ೆ ಮ ೂ ರ ್ ತ ಿ ಪ ೂ ಜ ೆ	O
ಹುರುಪು ಹುರುಪು	ಹ ು ರ ು ಪ ು ಹ ು ರ ು ಪ ು	O
ಹಾಗು ಹಾಗು	ಹ ಾ ಗ ು ಹ ಾ ಗ ು	O
ಬ್ಯಾರನ್ ಬ್ಯಾರನ್	ಬ ್ ಯ ಾ ರ ನ ್ ಬ ್ ಯ ಾ ರ ನ ್	O
ವೆಲ್ಲೆಸ್ಲಿಯು ವೆಲ್ಲೆಸ್ಲಿಯು	ವ ೆ ಲ ್ ಲ ೆ ಸ ್ ಲ ಿ ಯ ು ವ ೆ ಲ ್ ಲ ೆ ಸ ್ ಲ ಿ ಯ ು	 PER
	
೧೬ ೧೬	೧ ೬ ೧ ೬	TME
	
ಬಳ್ಳಾರಿ ಬಳ್ಳಾರಿ	ಬ ಳ ್ ಳ ಾ ರ ಿ ಬ ಳ ್ ಳ ಾ ರ ಿ	 LOC
	
ಪತ್ರದಲ್ಲಿ ಪತ್ರದಲ್ಲಿ	ಪ ತ ್ ರ ದ ಲ ್ ಲ ಿ ಪ ತ ್ ರ ದ ಲ ್ ಲ ಿ	O
ಆರ್ಯಪುರ ಆರ್ಯಪುರ	ಆ ರ ್ ಯ ಪ ು ರ ಆ ರ ್ ಯ ಪ ು ರ	B-LOC
ಶಾಖೆಗಳ ಶಾಖೆಗಳ	ಶ ಾ ಖ ೆ ಗ ಳ ಶ ಾ ಖ ೆ ಗ ಳ	O
ಭಾಗದ ಭಾಗದ	ಭ ಾ ಗ ದ ಭ ಾ ಗ ದ	O
ಸಾಮ್ರಾಜ್ಯದ ಸಾಮ್ರಾಜ್ಯದ	ಸ ಾ ಮ ್ ರ ಾ ಜ ್ ಯ ದ ಸ ಾ ಮ ್ ರ ಾ ಜ ್ ಯ ದ	O
ಬಾಗತಪುರ್ ಬಾಗತಪುರ್	ಬ ಾ ಗ ತ ಪ ು ರ ್ ಬ ಾ ಗ ತ ಪ ು ರ ್	B-LOC
ಆಳ್ವಿಕೆಯನ್ನು ಆಳ್ವಿಕೆಯನ್ನು	ಆ ಳ ್ ವ ಿ ಕ ೆ ಯ ನ ್ ನ ು ಆ ಳ ್ ವ ಿ ಕ ೆ ಯ ನ ್ ನ ು	O
ಕ್ರಮಗಳಿಗೆ ಕ್ರಮಗಳಿಗೆ	ಕ ್ ರ ಮ ಗ ಳ ಿ ಗ ೆ ಕ ್ ರ ಮ ಗ ಳ ಿ ಗ ೆ	O
ನಿರ್ಮಿಸಲಾಯಿತು ನಿರ್ಮಿಸಲಾಯಿತು	ನ ಿ ರ ್ ಮ ಿ ಸ ಲ ಾ ಯ ಿ ತ ು ನ ಿ ರ ್ ಮ ಿ ಸ ಲ ಾ ಯ ಿ ತ ು	O
ಕೊಂದರು ಕೊಂದರು	ಕ ೊ ಂ ದ ರ ು ಕ ೊ ಂ ದ ರ ು	O
	
ಕನ್ನಡ ಕನ್ನಡ	ಕ ನ ್ ನ ಡ ಕ ನ ್ ನ ಡ	 LOC
ಮತ್ತು ಮತ್ತು	ಮ ತ ್ ತ ು ಮ ತ ್ ತ ು	O
ಅಲೆಗ್ಸಾಂಡರನ ಅಲೆಗ್ಸಾಂಡರನ	ಅ ಲ ೆ ಗ ್ ಸ ಾ ಂ ಡ ರ ನ ಅ ಲ ೆ ಗ ್ ಸ ಾ ಂ ಡ ರ ನ	B-PER
ಕಟ್ಟಿಸಿದ ಕಟ್ಟಿಸಿದ	ಕ ಟ ್ ಟ ಿ ಸ ಿ ದ ಕ ಟ ್ ಟ ಿ ಸ ಿ ದ	O
ಬಹಳ ಬಹಳ	ಬ ಹ ಳ ಬ ಹ ಳ	O
ಜವಾಬ್ದಾರಿ ಜವಾಬ್ದಾರಿ	ಜ ವ ಾ ಬ ್ ದ ಾ ರ ಿ ಜ ವ ಾ ಬ ್ ದ ಾ ರ ಿ	O
ಕೆ ಕೆ	ಕ ೆ ಕ ೆ	O
ಕಳುಹಿಸಿದ್ದನು ಕಳುಹಿಸಿದ್ದನು	ಕ ಳ ು ಹ ಿ ಸ ಿ ದ ್ ದ ನ ು ಕ ಳ ು ಹ ಿ ಸ ಿ ದ ್ ದ ನ ು	O
ಸುಲ್ತಾನ ಸುಲ್ತಾನ	ಸ ು ಲ ್ ತ ಾ ನ ಸ ು ಲ ್ ತ ಾ ನ	 PER
ಒಂದು ಒಂದು	ಒ ಂ ದ ು
. .	. .	O
ಕಾಂಗ್ರೆಸ್ ಕಾಂಗ್ರೆಸ್	ಕ ಾ ಂ ಗ ್ ರ ೆ ಸ ್ ಕ ಾ ಂ ಗ ್ ರ ೆ ಸ ್	ORG
ಕನ್ನಡ ಕನ್ನಡ	ಕ ನ ್ ನ ಡ ಕ ನ ್ ನ ಡ	O
ವಿಸ್ತರಣೆಗೆ ವಿಸ್ತರಣೆಗೆ	ವ ಿ ಸ ್ ತ ರ ಣ ೆ ಗ ೆ ವ ಿ ಸ ್ ತ ರ ಣ ೆ ಗ ೆ	O
ಭೇಟಿಯಾಗಲು ಭೇಟಿಯಾಗಲು	ಭ ೇ ಟ ಿ ಯ ಾ ಗ ಲ ು ಭ ೇ ಟ ಿ ಯ ಾ ಗ ಲ ು	O
ಇಲ್ಲಿರುವ ಇಲ್ಲಿರುವ	ಇ ಲ ್ ಲ ಿ ರ ು ವ ಇ ಲ ್ ಲ ಿ ರ ು ವ	O
ಸ್ಥಾಪನೆಯಲ್ಲಿ ಸ್ಥಾಪನೆಯಲ್ಲಿ	ಸ ್ ಥ ಾ ಪ ನ ೆ ಯ ಲ ್ ಲ ಿ ಸ ್ ಥ ಾ ಪ ನ ೆ ಯ ಲ ್ ಲ ಿ	O
ಬೀದರ್ ಬೀದರ್	ಬ ೀ ದ ರ ್ ಬ ೀ ದ ರ ್	O
ಸಂದಿಗ್ಧ ಸಂದಿಗ್ಧ	ಸ ಂ ದ ಿ ಗ ್ ಧ ಸ ಂ ದ ಿ ಗ ್ ಧ	O
ಪ್ರತಿಕ್ರಿಯೆ ಪ್ರತಿಕ್ರಿಯೆ	ಪ ್ ರ ತ ಿ ಕ ್ ರ ಿ ಯ ೆ ಪ ್ ರ ತ ಿ ಕ ್ ರ ಿ ಯ ೆ	O
ಹುಲಿ ಹುಲಿ	ಹ ು ಲ ಿ ಹ ು ಲ ಿ	O
ಶರತ್ಕಾಲದಲ್ಲಿ ಶರತ್ಕಾಲದಲ್ಲಿ	ಶ ರ ತ ್ ಕ ಾ ಲ ದ ಲ ್ ಲ ಿ ಶ ರ ತ ್ ಕ ಾ ಲ ದ ಲ ್ ಲ ಿ	O
	
ನಗರ ನಗರ	ನ ಗ ರ ನ ಗ ರ	O
ಶಿಲಾಶಾಸನಗಳಲ್ಲಿಯ ಶಿಲಾಶಾಸನಗಳಲ್ಲಿಯ	ಶ ಿ ಲ ಾ ಶ ಾ ಸ ನ ಗ ಳ ಲ ್ ಲ ಿ ಯ ಶ ಿ ಲ ಾ ಶ ಾ ಸ ನ ಗ ಳ ಲ ್ ಲ ಿ ಯ	O
ಕ್ರಿ ಕ್ರಿ	ಕ ್ ರ ಿ ಕ ್ ರ ಿ	TME
ಹೇಳಿದ್ದರೆ ಹೇಳಿದ್ದರೆ	ಹ ೇ ಳ ಿ ದ ್ ದ ರ ೆ ಹ ೇ ಳ ಿ ದ ್ ದ ರ ೆ	O
ಬಗ್ಗೆ ಬಗ್ಗೆ	ಬ ಗ ್ ಗ ೆ ಬ ಗ ್ ಗ ೆ	O
ಇತಿಹಾಸದ ಇತಿಹಾಸದ	ಇ ತ ಿ ಹ ಾ ಸ ದ ಇ ತ ಿ ಹ ಾ ಸ ದ	O
ಕಾಲ ಕಾಲ	ಕ ಾ ಲ ಕ ಾ ಲ	O
೨ ೨	೨
ಸರ್ ಸರ್	ಸ ರ ್ ಸ ರ ್	O
೯೫೪ ೯೫೪	೯ ೫ ೪ ೯ ೫ ೪	TME
ಅಲೆಕ್ಸ್ ಅಲೆಕ್ಸ್	ಅ ಲ ೆ ಕ ್ ಸ ್ ಅ ಲ ೆ ಕ ್ ಸ ್	B-PER
. .	. .	O
	
1822 1822	1 8 2 2 1 8 2 2	TME
ಕಥೆಯು ಕಥೆಯು	ಕ ಥ ೆ ಯ ು ಕ ಥ ೆ ಯ ು	O
, ,	, ,	O
, ,	, ,	O
೧೮೫೯ರ ೧೮೫೯ರ	೧ ೮ ೫ ೯ ರ ೧ ೮ ೫ ೯ ರ	TME
, ,	, ,	O
, ,	, ,	O
ಕಳೆದುಕೊಂಡ ಕಳೆದುಕೊಂಡ	ಕ ಳ ೆ ದ ು ಕ ೊ ಂ ಡ ಕ ಳ ೆ ದ ು ಕ ೊ ಂ ಡ	O
ತಕ್ಷಶಿಲೆಗೆ ತಕ್ಷಶಿಲೆಗೆ	ತ ಕ ್ ಷ ಶ ಿ ಲ ೆ ಗ ೆ ತ ಕ ್ ಷ ಶ ಿ ಲ ೆ ಗ ೆ	B-LOC
ದಕ್ಷಿಣಭಾಗಕ್ಕೆ ದಕ್ಷಿಣಭಾಗಕ್ಕೆ	ದ ಕ ್ ಷ ಿ ಣ ಭ ಾ ಗ ಕ ್ ಕ ೆ ದ ಕ ್ ಷ ಿ ಣ ಭ ಾ ಗ ಕ ್ ಕ ೆ	 LOC
ರಾಜಪ್ರಭುತ್ವ ರಾಜಪ್ರಭುತ್ವ	ರ ಾ ಜ ಪ ್ ರ ಭ ು ತ ್ ವ ರ ಾ ಜ ಪ ್ ರ ಭ ು ತ ್ ವ	O
ಸುಂಕ ಸುಂಕ	ಸ ು ಂ ಕ ಸ ು ಂ ಕ	O
. .	. .	O
ಅಶೋಕ ಅಶೋಕ	ಅ ಶ ೋ ಕ ಅ ಶ ೋ ಕ	B-PER
ಮತ್ತ ಮತ್ತ	ಮ ತ ್ ತ ಮ ತ ್ ತ	O
ಸ್ವೀಕರಿಸಿದನು ಸ್ವೀಕರಿಸಿದನು	ಸ ್ ವ ಿ ೕ ಕ ರ ಿ ಸ ಿ ದ ನ ು ಸ ್ ವ ಿ ೕ ಕ ರ ಿ ಸ ಿ ದ ನ ು	O
ತನ್ನ ತನ್ನ	ತ ನ ್ ನ ತ ನ ್ ನ	O
ಸಹನೆಯ ಸಹನೆಯ	ಸ ಹ ನ ೆ ಯ ಸ ಹ ನ ೆ ಯ	O
ಕಾಣಬಹುದಿತ್ತು ಕಾಣಬಹುದಿತ್ತು	ಕ ಾ ಣ ಬ ಹ ು ದ ಿ ತ ್ ತ ು ಕ ಾ ಣ ಬ ಹ ು ದ ಿ ತ ್ ತ ು	O
, ,	, ,	O
ನದಿಯ ನದಿಯ	ನ ದ ಿ ಯ ನ ದ ಿ ಯ	 LOC
	
ಉಳಿಸಿಕೊಳ್ಳುವ ಉಳಿಸಿಕೊಳ್ಳುವ	ಉ ಳ ಿ ಸ ಿ ಕ ೊ ಳ ್ ಳ ು ವ ಉ ಳ ಿ ಸ ಿ ಕ ೊ ಳ ್ ಳ ು ವ	O
ಉದಾಹರಣೆಗೆ ಉದಾಹರಣೆಗೆ	ಉ ದ ಾ ಹ ರ ಣ ೆ ಗ ೆ ಉ ದ ಾ ಹ ರ ಣ ೆ ಗ ೆ	O
ಕಲೆ ಕಲೆ	ಕ ಲ ೆ ಕ ಲ ೆ	O
ನಿರ್ಮೂಲನ ನಿರ್ಮೂಲನ	ನ ಿ ರ ್ ಮ ೂ ಲ ನ ನ ಿ ರ ್ ಮ ೂ ಲ ನ	O
ಸಂಗೀತದ ಸಂಗೀತದ	ಸ ಂ ಗ ೀ ತ ದ ಸ ಂ ಗ ೀ ತ ದ	O
ಬ್ರಿಟಿಷ್ ಬ್ರಿಟಿಷ್	ಬ ್ ರ ಿ ಟ ಿ ಷ ್ ಬ ್ ರ ಿ ಟ ಿ ಷ ್	B-COM
. .	. .	O
ಇದರಿಂದಾಗಿ ಇದರಿಂದಾಗಿ	ಇ ದ ರ ಿ ಂ ದ ಾ ಗ ಿ ಇ ದ ರ ಿ ಂ ದ ಾ ಗ ಿ	O
ಬರವಣಿಗೆಯಿಂದ ಬರವಣಿಗೆಯಿಂದ	ಬ ರ ವ ಣ ಿ ಗ ೆ ಯ ಿ ಂ ದ ಬ ರ ವ ಣ ಿ ಗ ೆ ಯ ಿ ಂ ದ	O
ಮಾರ್ಗವಾಗಿ ಮಾರ್ಗವಾಗಿ	ಮ ಾ ರ ್ ಗ ವ ಾ ಗ ಿ ಮ ಾ ರ ್ ಗ ವ ಾ ಗ ಿ	O
. .	. .	O
ಇವು ಇವು	ಇ ವ ು ಇ ವ ು	O
1571ರ 1571ರ	1 5 7 1 ರ 1 5 7 1 ರ	TME
ಇದು ಇದು	ಇ ದ ು ಇ ದ ು	O
. .	. .	O
	
ಶಂಕೆಯಿಂದ ಶಂಕೆಯಿಂದ	ಶ ಂ ಕ ೆ ಯ ಿ ಂ ದ ಶ ಂ ಕ ೆ ಯ ಿ ಂ ದ	O
ಹೊಂದಿಕೊಂಡಿದೆ ಹೊಂದಿಕೊಂಡಿದೆ	ಹ ೊ ಂ ದ ಿ ಕ ೊ ಂ ಡ ಿ ದ ೆ ಹ ೊ ಂ ದ ಿ ಕ ೊ ಂ ಡ ಿ ದ ೆ	O
ವೆಂಕಟರಾಯ ವೆಂಕಟರಾಯ	ವ ೆ ಂ ಕ ಟ ರ ಾ ಯ ವ ೆ ಂ ಕ ಟ ರ ಾ ಯ	 PER
ಇದರ ಇದರ	ಇ ದ ರ ಇ ದ ರ	O
ನಂತರ ನಂತರ	ನ ಂ ತ ರ ನ ಂ ತ ರ	O
ಕಾರಣವನ್ನು ಕಾರಣವನ್ನು	ಕ ಾ ರ ಣ ವ ನ ್ ನ ು ಕ ಾ ರ ಣ ವ ನ ್ ನ ು	O
ಸಿವಾಲಿಕ್ ಸಿವಾಲಿಕ್	ಸ ಿ ವ ಾ ಲ ಿ ಕ ್ ಸ ಿ ವ ಾ ಲ ಿ ಕ ್	 LOC
. .	. .	O
ಈ ಈ	ಈ ಈ	O
ಹೊಂದಿ ಹೊಂದಿ	ಹ ೊ ಂ ದ ಿ ಹ ೊ ಂ ದ ಿ	O
1451 1451	1 4 5 1
ಹವೇಲಿ ಹವೇಲಿ	ಹ ವ ೇ ಲ ಿ ಹ ವ ೇ ಲ ಿ	 PER
ಸಾಮ್ರಾಜ್ಯದಲ್ಲಿ ಸಾಮ್ರಾಜ್ಯದಲ್ಲಿ	ಸ ಾ ಮ ್ ರ ಾ ಜ ್ ಯ ದ ಲ ್ ಲ ಿ ಸ ಾ ಮ ್ ರ ಾ ಜ ್ ಯ ದ ಲ ್ ಲ ಿ	O
ಗಂಗರು ಗಂಗರು	ಗ ಂ ಗ ರ ು ಗ ಂ ಗ ರ ು	B-COM
ಬೌದ್ಧಧರ್ಮ ಬೌದ್ಧಧರ್ಮ	ಬ ೌ ದ ್ ಧ ಧ ರ ್ ಮ ಬ ೌ ದ ್ ಧ ಧ ರ ್ ಮ	B-COM
	
ರೀತಿಯ ರೀತಿಯ	ರ ೀ ತ ಿ ಯ ರ ೀ ತ ಿ ಯ	O
ಪಟ್ಟಾಭಿಷೇಕದ ಪಟ್ಟಾಭಿಷೇಕದ	ಪ ಟ ್ ಟ ಾ ಭ ಿ ಷ ೇ ಕ ದ ಪ ಟ ್ ಟ ಾ ಭ ಿ ಷ ೇ ಕ ದ	O
ಭೂಗೋಳಶಾಸ್ತ್ರ ಭೂಗೋಳಶಾಸ್ತ್ರ	ಭ ೂ ಗ ೋ ಳ ಶ ಾ ಸ ್ ತ ್ ರ ಭ ೂ ಗ ೋ ಳ ಶ ಾ ಸ ್ ತ ್ ರ	O
ಹೈದ್ರಾಬಾದ ಹೈದ್ರಾಬಾದ	ಹ ೈ ದ ್ ರ ಾ ಬ ಾ ದ ಹ ೈ ದ ್ ರ ಾ ಬ ಾ ದ	 LOC
ವ್ಯವಸ್ಥೆ ವ್ಯವಸ್ಥೆ	ವ ್ ಯ ವ ಸ ್ ಥ ೆ ವ ್ ಯ ವ ಸ ್ ಥ ೆ	O
ಕಲ್ಲಿನ ಕಲ್ಲಿನ	ಕ ಲ ್ ಲ ಿ ನ ಕ ಲ ್ ಲ ಿ ನ	O
ಹಾಕುವದು ಹಾಕುವದು	ಹ ಾ ಕ ು ವ ದ ು ಹ ಾ ಕ ು ವ ದ ು	O
ಮರಣಾನಂತರ ಮರಣಾನಂತರ	ಮ ರ ಣ ಾ ನ ಂ ತ ರ ಮ ರ ಣ ಾ ನ ಂ ತ ರ	O
. .	. .	O
ಅವಧಿಯ ಅವಧಿಯ	ಅ ವ ಧ ಿ ಯ ಅ ವ ಧ ಿ ಯ	O
ಮುಂದೆ ಮುಂದೆ	ಮ ು ಂ ದ ೆ ಮ ು ಂ ದ ೆ	O
ಆಳಿತದ ಆಳಿತದ	ಆ ಳ ಿ ತ ದ ಆ ಳ ಿ ತ ದ	O
ಜೊತೆಯಲ್ಲಿಯೇ ಜೊತೆಯಲ್ಲಿಯೇ	ಜ ೊ ತ ೆ ಯ ಲ ್ ಲ ಿ ಯ ೇ ಜ ೊ ತ ೆ ಯ ಲ ್ ಲ ಿ ಯ ೇ	O
ಮತ್ತು ಮತ್ತು	ಮ ತ ್ ತ ು ಮ ತ ್ ತ ು	O
. .	. .	O
ವಿಜಯದ ವಿಜಯದ	ವ ಿ ಜ ಯ ದ ವ ಿ ಜ ಯ ದ	O
ಮುಘಲ್ ಮುಘಲ್	ಮ ು ಘ ಲ ್ ಮ ು ಘ ಲ ್	B-COM
	
ಕೋಟೆಯನ್ನು ಕೋಟೆಯನ್ನು	ಕ ೋ ಟ ೆ ಯ ನ ್ ನ ು ಕ ೋ ಟ ೆ ಯ ನ ್ ನ ು	O
ಕೆಲವು ಕೆಲವು	ಕ ೆ ಲ ವ ು ಕ ೆ ಲ ವ ು	O
ರಾಜ್ಯದ ರಾಜ್ಯದ	ರ ಾ ಜ ್ ಯ ದ ರ ಾ ಜ ್ ಯ ದ	 LOC
ಸಮರ್ಥಿಸುತ್ತವೆ ಸಮರ್ಥಿಸುತ್ತವೆ	ಸ ಮ ರ ್ ಥ ಿ ಸ ು ತ ್ ತ ವ ೆ ಸ ಮ ರ ್ ಥ ಿ ಸ ು ತ ್ ತ ವ ೆ	O
ದೇವರನ್ನು ದೇವರನ್ನು	ದ ೇ ವ ರ ನ ್ ನ ು ದ ೇ ವ ರ ನ ್ ನ ು	TME
ಟೋಂಕ್ಗಳನ್ನು ಟೋಂಕ್ಗಳನ್ನು	ಟ ೋ ಂ ಕ ್ ಗ ಳ ನ ್ ನ ು ಟ ೋ ಂ ಕ ್ ಗ ಳ ನ ್ ನ ು	B-LOC
ಕಳೆದುಕೊಂಡನು ಕಳೆದುಕೊಂಡನು	ಕ ಳ ೆ ದ ು ಕ ೊ ಂ ಡ ನ ು ಕ ಳ ೆ ದ ು ಕ ೊ ಂ ಡ ನ ು	O
ಅಂತೂ ಅಂತೂ	ಅ ಂ ತ ೂ ಅ ಂ ತ ೂ	O
ದಂಗೆಯೊಂದನ್ನು ದಂಗೆಯೊಂದನ್ನು	ದ ಂ ಗ ೆ ಯ ೊ ಂ ದ ನ ್ ನ ು ದ ಂ ಗ ೆ ಯ ೊ ಂ ದ ನ ್ ನ ು	O
	
ಪ್ರಾರಂಭಿಸಿದ ಪ್ರಾರಂಭಿಸಿದ	ಪ ್ ರ ಾ ರ ಂ ಭ ಿ ಸ ಿ ದ ಪ ್ ರ ಾ ರ ಂ ಭ ಿ ಸ ಿ ದ	O
. .	. .	O
ಪ್ರೆಸಿಡೆನ್ಸಿಯಿಂದ ಪ್ರೆಸಿಡೆನ್ಸಿಯಿಂದ	ಪ ್ ರ ೆ ಸ ಿ ಡ ೆ ನ ್ ಸ ಿ ಯ ಿ ಂ ದ ಪ ್ ರ ೆ ಸ ಿ ಡ ೆ ನ ್ ಸ ಿ ಯ ಿ ಂ ದ	O
ಯುದ್ಧ ಯುದ್ಧ	ಯ ು ದ ್ ಧ ಯ ು ದ ್ ಧ	O
ರಾಜ್ಯದಲ್ಲಿರುವ ರಾಜ್ಯದಲ್ಲಿರುವ	ರ ಾ ಜ ್ ಯ ದ ಲ ್ ಲ ಿ ರ ು ವ ರ ಾ ಜ ್ ಯ ದ ಲ ್ ಲ ಿ ರ ು ವ	O
ಗುರುತಿಸಬಹುದು ಗುರುತಿಸಬಹುದು	ಗ ು ರ ು ತ ಿ ಸ ಬ ಹ ು ದ ು ಗ ು ರ ು ತ ಿ ಸ ಬ ಹ ು ದ ು	O
ಅಖಿಲ ಅಖಿಲ	ಅ ಖ ಿ ಲ ಅ ಖ ಿ ಲ	O
ಹರಿಕಾರ ಹರಿಕಾರ	ಹ ರ ಿ ಕ ಾ ರ ಹ ರ ಿ ಕ ಾ ರ	O
ಬ್ರಿಟಿಷರು ಬ್ರಿಟಿಷರು	ಬ ್ ರ ಿ ಟ ಿ ಷ ರ ು ಬ ್ ರ ಿ ಟ ಿ ಷ ರ ು	O
ನಿಂತು ನಿಂತು	ನ ಿ ಂ ತ ು ನ ಿ ಂ ತ ು	O
ಸವಾಲುಗಳನ್ನು ಸವಾಲುಗಳನ್ನು	ಸ ವ ಾ ಲ ು ಗ ಳ ನ ್ ನ ು ಸ ವ ಾ ಲ ು ಗ ಳ ನ ್ ನ ು	O
. .	. .	O
ನೆಪೋಲಿಯನ್ ನೆಪೋಲಿಯನ್	ನ ೆ ಪ ೋ ಲ ಿ ಯ ನ ್ ನ ೆ ಪ ೋ ಲ ಿ ಯ ನ ್	B-PER
ರಾಜೇಂದ್ರಪ್ರಸಾದರನ್ನು ರಾಜೇಂದ್ರಪ್ರಸಾದರನ್ನು	ರ ಾ ಜ ೇ ಂ ದ ್ ರ ಪ ್ ರ ಸ ಾ ದ ರ ನ ್ ನ ು ರ ಾ ಜ ೇ ಂ ದ ್ ರ ಪ ್ ರ ಸ ಾ ದ ರ ನ ್ ನ ು	 PER
ಕಟ್ಟಿದ್ದರು ಕಟ್ಟಿದ್ದರು	ಕ ಟ ್ ಟ ಿ ದ ್ ದ ರ ು ಕ ಟ ್ ಟ ಿ ದ ್ ದ ರ ು	O
ಪರಿಷತ್ತು ಪರಿಷತ್ತು	ಪ ರ ಿ ಷ ತ ್ ತ ು ಪ ರ ಿ ಷ ತ ್ ತ ು	O
ದಿ ದಿ	ದ ಿ ದ ಿ	O
ಷಾಜಹಾನನ ಷಾಜಹಾನನ	ಷ ಾ ಜ ಹ ಾ ನ ನ ಷ ಾ ಜ ಹ ಾ ನ ನ	B-PER
	
ಮಾಡಿತು ಮಾಡಿತು	ಮ ಾ ಡ ಿ ತ ು ಮ ಾ ಡ ಿ ತ ು	O
ಹಳೆ ಹಳೆ	ಹ ಳ ೆ ಹ ಳ ೆ	B-LOC
ಕೋರಿಕೆ ಕೋರಿಕೆ	ಕ ೋ ರ ಿ ಕ ೆ ಕ ೋ ರ ಿ ಕ ೆ	O
	
ಮುಖ್ಯಮಂತ್ರಿ ಮುಖ್ಯಮಂತ್ರಿ	ಮ ು ಖ ್ ಯ ಮ ಂ ತ ್ ರ ಿ ಮ ು ಖ ್ ಯ ಮ ಂ ತ ್ ರ ಿ	B-ROL
ಪ್ರಾಚೀನ ಪ್ರಾಚೀನ	ಪ ್ ರ ಾ ಚ ೀ ನ ಪ ್ ರ ಾ ಚ ೀ ನ	O
ಬಿಂಬಿಸುತ್ತವೆ ಬಿಂಬಿಸುತ್ತವೆ	ಬ ಿ ಂ ಬ ಿ ಸ ು ತ ್ ತ ವ ೆ ಬ ಿ ಂ ಬ ಿ ಸ ು ತ ್ ತ ವ ೆ	O
ಎದೆಗುಂದದ ಎದೆಗುಂದದ	ಎ ದ ೆ ಗ ು ಂ ದ ದ ಎ ದ ೆ ಗ ು ಂ ದ ದ	O
ಬಂದ ಬಂದ	ಬ ಂ ದ ಬ ಂ ದ	O
ಅಲ್ಲದೆ ಅಲ್ಲದೆ	ಅ ಲ ್ ಲ ದ ೆ ಅ ಲ ್ ಲ ದ ೆ	O
. .	. .	O
ವ್ಯವಸ್ಥೆ ವ್ಯವಸ್ಥೆ	ವ ್ ಯ ವ ಸ ್ ಥ ೆ ವ ್ ಯ ವ ಸ ್ ಥ ೆ	O
. .	. .	O
ಆಡಳಿತದ ಆಡಳಿತದ	ಆ ಡ ಳ ಿ ತ ದ ಆ ಡ ಳ ಿ ತ ದ	O
ಸರ್ಕಾರ ಸರ್ಕಾರ	ಸ ರ ್ ಕ ಾ ರ ಸ ರ ್ ಕ ಾ ರ	ORG
ಭುವನಗಿರಿದುರ್ಗ ಭುವನಗಿರಿದುರ್ಗ	ಭ ು ವ ನ ಗ ಿ ರ ಿ ದ ು ರ ್ ಗ ಭ ು ವ ನ ಗ ಿ ರ ಿ ದ ು ರ ್ ಗ	 LOC
ತಂದಿದ್ದ ತಂದಿದ್ದ	ತ ಂ ದ ಿ ದ ್ ದ ತ ಂ ದ ಿ ದ ್ ದ	O
ವಿರುದ್ದ ವಿರುದ್ದ	ವ ಿ ರ ು ದ ್ ದ ವ ಿ ರ ು ದ ್ ದ	O
, ,	, ,	O
ಕೋಲ್ಕತ್ತಾ ಕೋಲ್ಕತ್ತಾ	ಕ ೋ ಲ ್ ಕ ತ ್ ತ ಾ ಕ ೋ ಲ ್ ಕ ತ ್ ತ ಾ	 LOC
ಭಾರತವನ್ನು ಭಾರತವನ್ನು	ಭ ಾ ರ ತ ವ ನ ್ ನ ು ಭ ಾ ರ ತ ವ ನ ್ ನ ು	B-LOC
ಸಿಂಹಾಸನಾರೋಹಣವನ್ನು ಸಿಂಹಾಸನಾರೋಹಣವನ್ನು	ಸ ಿ ಂ ಹ ಾ ಸ ನ ಾ ರ ೋ ಹ ಣ ವ ನ ್ ನ ು ಸ ಿ ಂ ಹ ಾ ಸ ನ ಾ ರ ೋ ಹ ಣ ವ ನ ್ ನ ು	O
	
	
ಹನ್ನೆರಡು ಹನ್ನೆರಡು	ಹ ನ ್ ನ ೆ ರ ಡ ು
ನಿರಾಕರಿಸಿದರು ನಿರಾಕರಿಸಿದರು	ನ ಿ ರ ಾ ಕ ರ ಿ ಸ ಿ ದ ರ ು ನ ಿ ರ ಾ ಕ ರ ಿ ಸ ಿ ದ ರ ು	O
ಪಾಳೆಯಗಾರ ಪಾಳೆಯಗಾರ	ಪ ಾ ಳ ೆ ಯ ಗ ಾ ರ ಪ ಾ ಳ ೆ ಯ ಗ ಾ ರ	B-ROL
	
ಅಕ್ಬರ್ನನ್ನು ಅಕ್ಬರ್ನನ್ನು	ಅ ಕ ್ ಬ ರ ್ ನ ನ ್ ನ ು ಅ ಕ ್ ಬ ರ ್ ನ ನ ್ ನ ು	 PER
. .	. .	O
ಜನಿಸಿದನು ಜನಿಸಿದನು	ಜ ನ ಿ ಸ ಿ ದ ನ ು ಜ ನ ಿ ಸ ಿ ದ ನ ು	O
ತೈಲಪ ತೈಲಪ	ತ ೈ ಲ ಪ ತ ೈ ಲ ಪ	 PER
ಮಾಡಿದ ಮಾಡಿದ	ಮ ಾ ಡ ಿ ದ ಮ ಾ ಡ ಿ ದ	O
ಜಾರಿಗೆ ಜಾರಿಗೆ	ಜ ಾ ರ ಿ ಗ ೆ ಜ ಾ ರ ಿ ಗ ೆ	O
ಸೈನಿಕ ಸೈನಿಕ	ಸ ೈ ನ ಿ ಕ ಸ ೈ ನ ಿ ಕ	B-ROL
ಸಿಡಿದ ಸಿಡಿದ	ಸ ಿ ಡ ಿ ದ ಸ ಿ ಡ ಿ ದ	O
ಹಾಗೂ ಹಾಗೂ	ಹ ಾ ಗ ೂ ಹ ಾ ಗ ೂ	O
. .	. .	O
ಇದು ಇದು	ಇ ದ ು ಇ ದ ು	O
ಜಾತಿಯವನೆಂದು ಜಾತಿಯವನೆಂದು	ಜ ಾ ತ ಿ ಯ ವ ನ ೆ ಂ ದ ು ಜ ಾ ತ ಿ ಯ ವ ನ ೆ ಂ ದ ು	O
ರಾಜ್ಯಗಳ ರಾಜ್ಯಗಳ	ರ ಾ ಜ ್ ಯ ಗ ಳ ರ ಾ ಜ ್ ಯ ಗ ಳ	O
ಕೈಗೊಂಡು ಕೈಗೊಂಡು	ಕ ೈ ಗ ೊ ಂ ಡ ು ಕ ೈ ಗ ೊ ಂ ಡ ು	O
ಕಾರ್ಯಕಾರಿ ಕಾರ್ಯಕಾರಿ	ಕ ಾ ರ ್ ಯ ಕ ಾ ರ ಿ ಕ ಾ ರ ್ ಯ ಕ ಾ ರ ಿ	ORG
ಮಹಾಸೇನಾಪತಿ ಮಹಾಸೇನಾಪತಿ	ಮ ಹ ಾ ಸ ೇ ನ ಾ ಪ ತ ಿ ಮ ಹ ಾ ಸ ೇ ನ ಾ ಪ ತ ಿ	O
ಆನೆಗಳನ್ನು ಆನೆಗಳನ್ನು	ಆ ನ ೆ ಗ ಳ ನ ್ ನ ು ಆ ನ ೆ ಗ ಳ ನ ್ ನ ು	O
ಮುಂದುವರಿದನು ಮುಂದುವರಿದನು	ಮ ು ಂ ದ ು ವ ರ ಿ ದ ನ ು ಮ ು ಂ ದ ು ವ ರ ಿ ದ ನ ು	O
ತಪ್ಪದೆ ತಪ್ಪದೆ	ತ ಪ ್ ಪ ದ ೆ ತ ಪ ್ ಪ ದ ೆ	O
ವೇಷ ವೇಷ	ವ ೇ ಷ ವ ೇ ಷ	O
ಮಾಲಾ ಮಾಲಾ	ಮ ಾ ಲ ಾ ಮ ಾ ಲ ಾ	O
1816 1816	1 8 1 6 1 8 1 6	TME
ಕಾಣುವ ಕಾಣುವ	ಕ ಾ ಣ ು ವ ಕ ಾ ಣ ು ವ	O
೨೮ ೨೮	೨ ೮ ೨ ೮	TME
ದಂಗೆಯೆದ್ದು ದಂಗೆಯೆದ್ದು	ದ ಂ ಗ ೆ ಯ ೆ ದ ್ ದ ು ದ ಂ ಗ ೆ ಯ ೆ ದ ್ ದ ು	O
1919ರಲ್ಲಿ 1919ರಲ್ಲಿ	1 9 1 9 ರ ಲ ್ ಲ ಿ
ಘರಟ್ಟ ಘರಟ್ಟ	ಘ ರ ಟ ್ ಟ ಘ ರ ಟ ್ ಟ	O
ಬಿಡುಗಡೆ ಬಿಡುಗಡೆ	ಬ ಿ ಡ ು ಗ ಡ ೆ ಬ ಿ ಡ ು ಗ ಡ ೆ	O
ವಿಷಯಗಳಾದ ವಿಷಯಗಳಾದ	ವ ಿ ಷ ಯ ಗ ಳ ಾ ದ ವ ಿ ಷ ಯ ಗ ಳ ಾ ದ	O
ಸಾಗಿತು ಸಾಗಿತು	ಸ ಾ ಗ ಿ ತ ು ಸ ಾ ಗ ಿ ತ ು	O
ರಾನಡೆಯವರು ರಾನಡೆಯವರು	ರ ಾ ನ ಡ ೆ ಯ ವ ರ ು ರ ಾ ನ ಡ ೆ ಯ ವ ರ ು	 PER
	
ಮಹಾಗೋಡೆಚೀನಾದ ಮಹಾಗೋಡೆಚೀನಾದ	ಮ ಹ ಾ ಗ ೋ ಡ ೆ ಚ ೀ ನ ಾ ದ ಮ ಹ ಾ ಗ ೋ ಡ ೆ ಚ ೀ ನ ಾ ದ	B-LOC
೧೯೧೨ ೧೯೧೨	೧ ೯ ೧ ೨ ೧ ೯ ೧ ೨	TME
. .	. .	O
ದಟ್ಟ ದಟ್ಟ	ದ ಟ ್ ಟ ದ ಟ ್ ಟ	O
ಇಂತಹ ಇಂತಹ	ಇ ಂ ತ ಹ ಇ ಂ ತ ಹ	O
ಬೆಳಗಾವಿಗಳನ್ನು ಬೆಳಗಾವಿಗಳನ್ನು	ಬ ೆ ಳ ಗ ಾ ವ ಿ ಗ ಳ ನ ್ ನ ು ಬ ೆ ಳ ಗ ಾ ವ ಿ ಗ ಳ ನ ್ ನ ು	 LOC
ರೇಶಿಮೆಯ ರೇಶಿಮೆಯ	ರ ೇ ಶ ಿ ಮ ೆ ಯ ರ ೇ ಶ ಿ ಮ ೆ ಯ	O
ಮಾತ್ರನೆ ಮಾತ್ರನೆ	ಮ ಾ ತ ್ ರ ನ ೆ ಮ ಾ ತ ್ ರ ನ ೆ	O
	
ತುಂಗಭದ್ರೆಯ ತುಂಗಭದ್ರೆಯ	ತ ು ಂ ಗ ಭ ದ ್ ರ ೆ ಯ ತ ು ಂ ಗ ಭ ದ ್ ರ ೆ ಯ	B-LOC
ಬಿಟ್ಟು ಬಿಟ್ಟು	ಬ ಿ ಟ ್ ಟ ು ಬ ಿ ಟ ್ ಟ ು	O
ಭಾರತದ ಭಾರತದ	ಭ ಾ ರ ತ ದ ಭ ಾ ರ ತ ದ	B-LOC
ಸಾರಿ ಸಾರಿ	ಸ ಾ ರ ಿ ಸ ಾ ರ ಿ	O
. .	. .	O
ಮಿಶ್ರಾ ಮಿಶ್ರಾ	ಮ ಿ ಶ ್ ರ ಾ ಮ ಿ ಶ ್ ರ ಾ	B-PER
ಬೆಳೆಸಿದ ಬೆಳೆಸಿದ	ಬ ೆ ಳ ೆ ಸ ಿ ದ ಬ ೆ ಳ ೆ ಸ ಿ ದ	O
ಬಂಗಾರವಾಗಿದೆ ಬಂಗಾರವಾಗಿದೆ	ಬ ಂ ಗ ಾ ರ ವ ಾ ಗ ಿ ದ ೆ ಬ ಂ ಗ ಾ ರ ವ ಾ ಗ ಿ ದ ೆ	O
ಸೇರಿದ ಸೇರಿದ	ಸ ೇ ರ ಿ ದ ಸ ೇ ರ ಿ ದ	O
ಹೀಗೆ ಹೀಗೆ	ಹ ೀ ಗ ೆ ಹ ೀ ಗ ೆ	O
ಮಹತ್ವ ಮಹತ್ವ	ಮ ಹ ತ ್ ವ ಮ ಹ ತ ್ ವ	O
ಯಾವ ಯಾವ	ಯ ಾ ವ ಯ ಾ ವ	O
ಕ್ಲಿಷ್ಟ ಕ್ಲಿಷ್ಟ	ಕ ್ ಲ ಿ ಷ ್ ಟ ಕ ್ ಲ ಿ ಷ ್ ಟ	O
. .	. .	O
ಸಾಮಾನ್ಯವಾಗಿ ಸಾಮಾನ್ಯವಾಗಿ	ಸ ಾ ಮ ಾ ನ ್ ಯ ವ ಾ ಗ ಿ ಸ ಾ ಮ ಾ ನ ್ ಯ ವ ಾ ಗ ಿ	O
ಮಾಡಲು ಮಾಡಲು	ಮ ಾ ಡ ಲ ು ಮ ಾ ಡ ಲ ು	O
. .	. .	O
ಮತ್ತು ಮತ್ತು	ಮ ತ ್ ತ ು ಮ ತ ್ ತ ು	O
. .	. .	O
ವಿಸ್ತರಿಸಲಾಯಿತು ವಿಸ್ತರಿಸಲಾಯಿತು	ವ ಿ ಸ ್ ತ ರ ಿ ಸ ಲ ಾ ಯ ಿ ತ ು ವ ಿ ಸ ್ ತ ರ ಿ ಸ ಲ ಾ ಯ ಿ ತ ು	O
ವರ್ಷಗಳಲ್ಲಿ ವರ್ಷಗಳಲ್ಲಿ	ವ ರ ್ ಷ ಗ ಳ ಲ ್ ಲ ಿ ವ ರ ್ ಷ ಗ ಳ ಲ ್ ಲ ಿ	O
, ,	, ,	O
ಬಂಧುವರ್ಗಕ್ಕೆಲ್ಲ ಬಂಧುವರ್ಗಕ್ಕೆಲ್ಲ	ಬ ಂ ಧ ು ವ ರ ್ ಗ ಕ ್ ಕ ೆ ಲ ್ ಲ ಬ ಂ ಧ ು ವ ರ ್ ಗ ಕ ್ ಕ ೆ ಲ ್ ಲ	O
ಉಳಿದುಕೊಂಡು ಉಳಿದುಕೊಂಡು	ಉ ಳ ಿ ದ ು ಕ ೊ ಂ ಡ ು ಉ ಳ ಿ ದ ು ಕ ೊ ಂ ಡ ು	O
ಮುಂಚೂಣಿಗೆ ಮುಂಚೂಣಿಗೆ	ಮ ು ಂ ಚ ೂ ಣ ಿ ಗ ೆ ಮ ು ಂ ಚ ೂ ಣ ಿ ಗ ೆ	O
	
30 30	3 0 3 0	TME
ನ ನ	ನ ನ	O
ಗಳಿಸಿ ಗಳಿಸಿ	ಗ ಳ ಿ ಸ ಿ ಗ ಳ ಿ ಸ ಿ	O
ತಡೆಗಟ್ಟುವ ತಡೆಗಟ್ಟುವ	ತ ಡ ೆ ಗ ಟ ್ ಟ ು ವ ತ ಡ ೆ ಗ ಟ ್ ಟ ು ವ	O
ಜಾಲೋರ್ ಜಾಲೋರ್	ಜ ಾ ಲ ೋ ರ ್ ಜ ಾ ಲ ೋ ರ ್	B-LOC
ಉದ್ಧೇಶದಿಂದ ಉದ್ಧೇಶದಿಂದ	ಉ ದ ್ ಧ ೇ ಶ ದ ಿ ಂ ದ ಉ ದ ್ ಧ ೇ ಶ ದ ಿ ಂ ದ	O
	
ಐಕ್ಯತೆಯನ್ನು ಐಕ್ಯತೆಯನ್ನು	ಐ ಕ ್ ಯ ತ ೆ ಯ ನ ್ ನ ು ಐ ಕ ್ ಯ ತ ೆ ಯ ನ ್ ನ ು	O
ಸುರಕ್ಷಿತ ಸುರಕ್ಷಿತ	ಸ ು ರ ಕ ್ ಷ ಿ ತ ಸ ು ರ ಕ ್ ಷ ಿ ತ	O
ವಿಗ್ರಹಗಳು ವಿಗ್ರಹಗಳು	ವ ಿ ಗ ್ ರ ಹ ಗ ಳ ು ವ ಿ ಗ ್ ರ ಹ ಗ ಳ ು	O
ಶತ್ರುವನ್ನು ಶತ್ರುವನ್ನು	ಶ ತ ್ ರ ು ವ ನ ್ ನ ು ಶ ತ ್ ರ ು ವ ನ ್ ನ ು	O
ವಶವಾಯಿತು ವಶವಾಯಿತು	ವ ಶ ವ ಾ ಯ ಿ ತ ು ವ ಶ ವ ಾ ಯ ಿ ತ ು	O
ಸತ್ಯವು ಸತ್ಯವು	ಸ ತ ್ ಯ ವ ು ಸ ತ ್ ಯ ವ ು	O
ನಗರದ ನಗರದ	ನ ಗ ರ ದ ನ ಗ ರ ದ	O
ಹೆಸರಾಗಿದ್ದಾಳೆ ಹೆಸರಾಗಿದ್ದಾಳೆ	ಹ ೆ ಸ ರ ಾ ಗ ಿ ದ ್ ದ ಾ ಳ ೆ ಹ ೆ ಸ ರ ಾ ಗ ಿ ದ ್ ದ ಾ ಳ ೆ	O
ಖುಜುರಾಹೋದ ಖುಜುರಾಹೋದ	ಖ ು ಜ ು ರ ಾ ಹ ೋ ದ ಖ ು ಜ ು ರ ಾ ಹ ೋ ದ	B-LOC
ರೆಂತಲೂ ರೆಂತಲೂ	ರ ೆ ಂ ತ ಲ ೂ ರ ೆ ಂ ತ ಲ ೂ	O
ಪ್ರತಿಯೊಂದು ಪ್ರತಿಯೊಂದು	ಪ ್ ರ ತ ಿ ಯ ೊ ಂ ದ ು ಪ ್ ರ ತ ಿ ಯ ೊ ಂ ದ ು	O
ಅಡ್ಡಗೋಡೆಯಂತೆ ಅಡ್ಡಗೋಡೆಯಂತೆ	ಅ ಡ ್ ಡ ಗ ೋ ಡ ೆ ಯ ಂ ತ ೆ ಅ ಡ ್ ಡ ಗ ೋ ಡ ೆ ಯ ಂ ತ ೆ	O
ಇಮ್ಮಡಿ ಇಮ್ಮಡಿ	ಇ ಮ ್ ಮ ಡ ಿ ಇ ಮ ್ ಮ ಡ ಿ	B-PER
, ,	, ,	O
ಹೆಸರು ಹೆಸರು	ಹ ೆ ಸ ರ ು ಹ ೆ ಸ ರ ು	O
ಮೊದಮೊದಲು ಮೊದಮೊದಲು	ಮ ೊ ದ ಮ ೊ ದ ಲ ು ಮ ೊ ದ ಮ ೊ ದ ಲ ು	O
ಧಾಳಿ ಧಾಳಿ	ಧ ಾ ಳ ಿ ಧ ಾ ಳ ಿ	O
ಅಕ್ಟೊಬರ್ ಅಕ್ಟೊಬರ್	ಅ ಕ ್ ಟ ೊ ಬ ರ ್ ಅ ಕ ್ ಟ ೊ ಬ ರ ್	TME
ಪಲ್ಲವರು ಪಲ್ಲವರು	ಪ ಲ ್ ಲ ವ ರ ು ಪ ಲ ್ ಲ ವ ರ ು	O
ನಾಲ್ಕುಸಾವಿರ ನಾಲ್ಕುಸಾವಿರ	ನ ಾ ಲ ್ ಕ ು ಸ ಾ ವ ಿ ರ
ಮತ್ತು ಮತ್ತು	ಮ ತ ್ ತ ು ಮ ತ ್ ತ ು	O
ಭಾಗದ ಭಾಗದ	ಭ ಾ ಗ ದ ಭ ಾ ಗ ದ	O
ಮುಂತಾದವುಗಳಿಗೆ ಮುಂತಾದವುಗಳಿಗೆ	ಮ ು ಂ ತ ಾ ದ ವ ು ಗ ಳ ಿ ಗ ೆ ಮ ು ಂ ತ ಾ ದ ವ ು ಗ ಳ ಿ ಗ ೆ	O
	ಕಾಂಗ್ರೆಸ್[ORG] ನೇತೃತ್ವದ[LOC] ಬ್ರಿಟಿಷ್[LOC] ವಸ್ತುಗಳ[LOC] ಬಹಿಷ್ಕಾರ[LOC] ಎಷ್ಟು ಸಫಲವಾಯಿತೆಂದರೆ ಸಿಪಾಯಿದಂಗೆಯ[LOC] ನಂತರ ಅತಿ ದೊಡ್ಡದೆಂಬಂಥ ಆಂಗ್ಲ[LOC] ವಿರೋಧೀ ಎಲ್ಲ[LOC] ಶಕ್ತಿಗಳನ್ನೂ ಒಮ್ಮೆಲೇ ಅದು ಆಂಗ್ಲರ[LOC] ಮೇಲೆ ತೂರಿಬಿಟ್ಟಂತಾಯಿತು. ಮತ್ತೆ ಹಿಂಸೆ ಹಾಗೂ ದಮನದ[LOC] ಚಕ್ರ[LOC] ದೇಶದ[LOC] ಅಲ್ಲಲ್ಲಿ ತಲೆದೋರಿತು (ನೋಡಿ:ಅಲಿಪುರದ[LOC] ಸ್ಫೋಟ[EVT]). ೧೯೦೯ ರಲ್ಲಿ, ಆಂಗ್ಲರು[LOC] ವಿವಿಧ[LOC] ಸಾಂವಿಧಾನಿಕ[LOC] ಸುಧಾರಣೆಗಳ[LOC] ಮೂಲಕ ತಲೆಸವರುವ[LOC] ಪ್ರಯತ್ನಗಳನ್ನೆಲ್ಲಾ ಮಾಡಿದರು ಮತ್ತು ಕೆಲವು ನಿರ್ವಾಹಕರುಗಳನ್ನು[LOC] ಪ್ರಾಂತೀಯ[LOC] ಹಾಗೂ ಸಾರ್ವಭೌಮ[LOC] ಸಭೆಗಳಿಗೆ[LOC] ನಿಯೋಜಿಸಿದರು. ಮುಸ್ಲಿಮರ[LOC] ಒಂದು ನಿಯೋಗ[LOC] ವೈಸ್‍ರಾಯ್[LOC] ಲಾರ್ಡ್[PER] ಮಿಂಟೋ[PER] (೧೯೦೫-೧೦[LOC]) ಅನ್ನು ಭೇಟಿಯಾಗಿ, ಮುಂದಾಗಲಿರುವ[LOC] ಸಾಂವಿಧಾನಿಕ[LOC] ಸುಧಾರಣೆಗಳಲ್ಲಿ[LOC] ಮುಸ್ಲಿ
ವಾದ ವಾದ	ವ ಾ ದ ವ ಾ ದ	O
ಪಾಶ್ಚಾತ್ಯ ಪಾಶ್ಚಾತ್ಯ	ಪ ಾ ಶ ್ ಚ ಾ ತ ್ ಯ ಪ ಾ ಶ ್ ಚ ಾ ತ ್ ಯ	O
ತನ್ನ ತನ್ನ	ತ ನ ್ ನ ತ ನ ್ ನ	O
	
ಮತ್ತು ಮತ್ತು	ಮ ತ ್ ತ ು ಮ ತ ್ ತ ು	O
ಜನವರಿ ಜನವರಿ	ಜ ನ ವ ರ ಿ ಜ ನ ವ ರ ಿ	TME
ಇವರು ಇವರು	ಇ ವ ರ ು ಇ ವ ರ ು	O
ಒದಗಿಸಿಕೊಡುತ್ತದೆ ಒದಗಿಸಿಕೊಡುತ್ತದೆ	ಒ ದ ಗ ಿ ಸ ಿ ಕ ೊ ಡ ು ತ ್ ತ ದ ೆ ಒ ದ ಗ ಿ ಸ ಿ ಕ ೊ ಡ ು ತ ್ ತ ದ ೆ	O
ವಿಚಾರಶೀಲರಾದ ವಿಚಾರಶೀಲರಾದ	ವ ಿ ಚ ಾ ರ ಶ ೀ ಲ ರ ಾ ದ ವ ಿ ಚ ಾ ರ ಶ ೀ ಲ ರ ಾ ದ	O
58ರಲ್ಲಿ 58ರಲ್ಲಿ	5 8 ರ ಲ ್ ಲ ಿ
ಬೆಂಗಳೂರಿನಿಂದ ಬೆಂಗಳೂರಿನಿಂದ	ಬ ೆ ಂ ಗ ಳ ೂ ರ ಿ ನ ಿ ಂ ದ ಬ ೆ ಂ ಗ ಳ ೂ ರ ಿ ನ ಿ ಂ ದ	B-LOC
ಬೋಧಿಸಿದನು ಬೋಧಿಸಿದನು	ಬ ೋ ಧ ಿ ಸ ಿ ದ ನ ು ಬ ೋ ಧ ಿ ಸ ಿ ದ ನ ು	O
. .	. .	O
ಜನಪ್ರಿಯವಾಗಿದೆ ಜನಪ್ರಿಯವಾಗಿದೆ	ಜ ನ ಪ ್ ರ ಿ ಯ ವ ಾ ಗ ಿ ದ ೆ ಜ ನ ಪ ್ ರ ಿ ಯ ವ ಾ ಗ ಿ ದ ೆ	O
. .	. .	O
ಪ್ರಮುಖ ಪ್ರಮುಖ	ಪ ್ ರ ಮ ು ಖ ಪ ್ ರ ಮ ು ಖ	O
ಜಿಲ್ಲೆಯ ಜಿಲ್ಲೆಯ	ಜ ಿ ಲ ್ ಲ ೆ ಯ ಜ ಿ ಲ ್ ಲ ೆ ಯ	O
. .	. .	O
ಪ್ರಭಾವಿತರಾಗಿ ಪ್ರಭಾವಿತರಾಗಿ	ಪ ್ ರ ಭ ಾ ವ ಿ ತ ರ ಾ ಗ ಿ ಪ ್ ರ ಭ ಾ ವ ಿ ತ ರ ಾ ಗ ಿ	O
ಮಹಾ ಮಹಾ	ಮ ಹ ಾ ಮ ಹ ಾ	O
ಜನ ಜನ	ಜ ನ ಜ ನ	O
ಬೀದರ್ ಬೀದರ್	ಬ ೀ ದ ರ ್ ಬ ೀ ದ ರ ್	 LOC
ಕೆಲವು ಕೆಲವು	ಕ ೆ ಲ ವ ು ಕ ೆ ಲ ವ ು	O
ಪ್ರಮುಖರಾಗಿದ್ದರು ಪ್ರಮುಖರಾಗಿದ್ದರು	ಪ ್ ರ ಮ ು ಖ ರ ಾ ಗ ಿ ದ ್ ದ ರ ು ಪ ್ ರ ಮ ು ಖ ರ ಾ ಗ ಿ ದ ್ ದ ರ ು	O
ದೇವಲೋಕವನ್ನು ದೇವಲೋಕವನ್ನು	ದ ೇ ವ ಲ ೋ ಕ ವ ನ ್ ನ ು ದ ೇ ವ ಲ ೋ ಕ ವ ನ ್ ನ ು	O
ದಂಡಿ ದಂಡಿ	ದ ಂ ಡ ಿ ದ ಂ ಡ ಿ	O
ಅಧಿಕಾರದಿಂದ ಅಧಿಕಾರದಿಂದ	ಅ ಧ ಿ ಕ ಾ ರ ದ ಿ ಂ ದ ಅ ಧ ಿ ಕ ಾ ರ ದ ಿ ಂ ದ	B-ROL
೪೮೩ ೪೮೩	೪ ೮ ೩
ಜೈನ ಜೈನ	ಜ ೈ ನ ಜ ೈ ನ	B-COM
ಕೂಡುವ ಕೂಡುವ	ಕ ೂ ಡ ು ವ ಕ ೂ ಡ ು ವ	O
ಮುಕ್ತವಾಗಿದ್ದ ಮುಕ್ತವಾಗಿದ್ದ	ಮ ು ಕ ್ ತ ವ ಾ ಗ ಿ ದ ್ ದ ಮ ು ಕ ್ ತ ವ ಾ ಗ ಿ ದ ್ ದ	O
ಕೆಲವು ಕೆಲವು	ಕ ೆ ಲ ವ ು ಕ ೆ ಲ ವ ು	O
. .	. .	O
ಸಮಾವೇಶದಲ್ಲಿ ಸಮಾವೇಶದಲ್ಲಿ	ಸ ಮ ಾ ವ ೇ ಶ ದ ಲ ್ ಲ ಿ ಸ ಮ ಾ ವ ೇ ಶ ದ ಲ ್ ಲ ಿ	O
ಪೇಶ್ವೆಯರ ಪೇಶ್ವೆಯರ	ಪ ೇ ಶ ್ ವ ೆ ಯ ರ ಪ ೇ ಶ ್ ವ ೆ ಯ ರ	I-COM
	
ಮಂಸ ಮಂಸ	ಮ ಂ ಸ ಮ ಂ ಸ	O
ಎಂಬುವವನು ಎಂಬುವವನು	ಎ ಂ ಬ ು ವ ವ ನ ು ಎ ಂ ಬ ು ವ ವ ನ ು	O
ಒಂದು ಒಂದು	ಒ ಂ ದ ು
ತುರ್ಕಿ ತುರ್ಕಿ	ತ ು ರ ್ ಕ ಿ ತ ು ರ ್ ಕ ಿ	B-COM
ತೆರಳಿ ತೆರಳಿ	ತ ೆ ರ ಳ ಿ ತ ೆ ರ ಳ ಿ	O
ಮೀಸೆಯನ್ನು ಮೀಸೆಯನ್ನು	ಮ ೀ ಸ ೆ ಯ ನ ್ ನ ು ಮ ೀ ಸ ೆ ಯ ನ ್ ನ ು	O
ಮನೆಗೆ ಮನೆಗೆ	ಮ ನ ೆ ಗ ೆ ಮ ನ ೆ ಗ ೆ	O
ನೀಡಲಾಗುತ್ತಿತ್ತು ನೀಡಲಾಗುತ್ತಿತ್ತು	ನ ೀ ಡ ಲ ಾ ಗ ು ತ ್ ತ ಿ ತ ್ ತ ು ನ ೀ ಡ ಲ ಾ ಗ ು ತ ್ ತ ಿ ತ ್ ತ ು	O
. .	. .	O
ಅನೇಕ ಅನೇಕ	ಅ ನ ೇ ಕ ಅ ನ ೇ ಕ	O
ಸುಭದ್ರತೆ ಸುಭದ್ರತೆ	ಸ ು ಭ ದ ್ ರ ತ ೆ ಸ ು ಭ ದ ್ ರ ತ ೆ	O
ಚಕ್ರಾಧಿಪತ್ಯಗಳ ಚಕ್ರಾಧಿಪತ್ಯಗಳ	ಚ ಕ ್ ರ ಾ ಧ ಿ ಪ ತ ್ ಯ ಗ ಳ ಚ ಕ ್ ರ ಾ ಧ ಿ ಪ ತ ್ ಯ ಗ ಳ	O
ನಟರಾಜ ನಟರಾಜ	ನ ಟ ರ ಾ ಜ ನ ಟ ರ ಾ ಜ	O
ಅತ್ಯಾವಶ್ಯಕವೆಂದು ಅತ್ಯಾವಶ್ಯಕವೆಂದು	ಅ ತ ್ ಯ ಾ ವ ಶ ್ ಯ ಕ ವ ೆ ಂ ದ ು ಅ ತ ್ ಯ ಾ ವ ಶ ್ ಯ ಕ ವ ೆ ಂ ದ ು	O
ನಿಷೇಧಿಸಿದನು ನಿಷೇಧಿಸಿದನು	ನ ಿ ಷ ೇ ಧ ಿ ಸ ಿ ದ ನ ು ನ ಿ ಷ ೇ ಧ ಿ ಸ ಿ ದ ನ ು	O
ಮತ್ತು ಮತ್ತು	ಮ ತ ್ ತ ು ಮ ತ ್ ತ ು	O
ರಾಜ್ಯಕ್ಕೂ ರಾಜ್ಯಕ್ಕೂ	ರ ಾ ಜ ್ ಯ ಕ ್ ಕ ೂ ರ ಾ ಜ ್ ಯ ಕ ್ ಕ ೂ	O
ಪ್ರಶ್ನಿಸುವುದಿಲ್ಲ ಪ್ರಶ್ನಿಸುವುದಿಲ್ಲ	ಪ ್ ರ ಶ ್ ನ ಿ ಸ ು ವ ು ದ ಿ ಲ ್ ಲ ಪ ್ ರ ಶ ್ ನ ಿ ಸ ು ವ ು ದ ಿ ಲ ್ ಲ	O
ಮಂದಿಯನ್ನು ಮಂದಿಯನ್ನು	ಮ ಂ ದ ಿ ಯ ನ ್ ನ ು ಮ ಂ ದ ಿ ಯ ನ ್ ನ ು	O
ನೀಡಲಾಯಿತು ನೀಡಲಾಯಿತು	ನ ೀ ಡ ಲ ಾ ಯ ಿ ತ ು ನ ೀ ಡ ಲ ಾ ಯ ಿ ತ ು	O
ಚಾಲುಕ್ಯರ ಚಾಲುಕ್ಯರ	ಚ ಾ ಲ ು ಕ ್ ಯ ರ ಚ ಾ ಲ ು ಕ ್ ಯ ರ	B-COM
ಮೇವಾರ ಮೇವಾರ	ಮ ೇ ವ ಾ ರ ಮ ೇ ವ ಾ ರ	B-LOC
ಪಂಜಾಬ್ನಿಂದ ಪಂಜಾಬ್ನಿಂದ	ಪ ಂ ಜ ಾ ಬ ್ ನ ಿ ಂ ದ ಪ ಂ ಜ ಾ ಬ ್ ನ ಿ ಂ ದ	 LOC
, ,	, ,	O
ಹೆಣ್ಣು ಹೆಣ್ಣು	ಹ ೆ ಣ ್ ಣ ು ಹ ೆ ಣ ್ ಣ ು	O
, ,	, ,	O
ಅಷ್ಟ ಅಷ್ಟ	ಅ ಷ ್ ಟ ಅ ಷ ್ ಟ	O
ಸೋಲಿಸಿದನು ಸೋಲಿಸಿದನು	ಸ ೋ ಲ ಿ ಸ ಿ ದ ನ ು ಸ ೋ ಲ ಿ ಸ ಿ ದ ನ ು	O
. .	. .	O
	
. .	. .	O
. .	. .	O
, ,	, ,	O
ಜನತೆಯ ಜನತೆಯ	ಜ ನ ತ ೆ ಯ ಜ ನ ತ ೆ ಯ	O
ನೇತೃತ್ವದಲ್ಲಿ ನೇತೃತ್ವದಲ್ಲಿ	ನ ೇ ತ ೃ ತ ್ ವ ದ ಲ ್ ಲ ಿ ನ ೇ ತ ೃ ತ ್ ವ ದ ಲ ್ ಲ ಿ	O
	
ಸಂಗಡಿಗ ಸಂಗಡಿಗ	ಸ ಂ ಗ ಡ ಿ ಗ ಸ ಂ ಗ ಡ ಿ ಗ	O
	
ಸಾಧನವಾಗಿದ್ದವು ಸಾಧನವಾಗಿದ್ದವು	ಸ ಾ ಧ ನ ವ ಾ ಗ ಿ ದ ್ ದ ವ ು ಸ ಾ ಧ ನ ವ ಾ ಗ ಿ ದ ್ ದ ವ ು	O
ವಿನಾಶಗೊಳಿಸುತ್ತದೆ ವಿನಾಶಗೊಳಿಸುತ್ತದೆ	ವ ಿ ನ ಾ ಶ ಗ ೊ ಳ ಿ ಸ ು ತ ್ ತ ದ ೆ ವ ಿ ನ ಾ ಶ ಗ ೊ ಳ ಿ ಸ ು ತ ್ ತ ದ ೆ	O
ಒಳ್ಳೆಯ ಒಳ್ಳೆಯ	ಒ ಳ ್ ಳ ೆ ಯ ಒ ಳ ್ ಳ ೆ ಯ	O
ದಾಳಿ ದಾಳಿ	ದ ಾ ಳ ಿ ದ ಾ ಳ ಿ	O
ಆದರೆ ಆದರೆ	ಆ ದ ರ ೆ ಆ ದ ರ ೆ	O
ಸಾವಿರಹಳ್ಳಿಗಳು ಸಾವಿರಹಳ್ಳಿಗಳು	ಸ ಾ ವ ಿ ರ ಹ ಳ ್ ಳ ಿ ಗ ಳ ು
ಇಷ್ಟೊಂದು ಇಷ್ಟೊಂದು	ಇ ಷ ್ ಟ ೊ ಂ ದ ು ಇ ಷ ್ ಟ ೊ ಂ ದ ು	O
ಭೋದಿಸಿದನು ಭೋದಿಸಿದನು	ಭ ೋ ದ ಿ ಸ ಿ ದ ನ ು ಭ ೋ ದ ಿ ಸ ಿ ದ ನ ು	O
ಭಾಗ ಭಾಗ	ಭ ಾ ಗ ಭ ಾ ಗ	O
ಮಾಹಿತಿಗಳು ಮಾಹಿತಿಗಳು	ಮ ಾ ಹ ಿ ತ ಿ ಗ ಳ ು ಮ ಾ ಹ ಿ ತ ಿ ಗ ಳ ು	O
ಕೈಬಿಡುವ ಕೈಬಿಡುವ	ಕ ೈ ಬ ಿ ಡ ು ವ ಕ ೈ ಬ ಿ ಡ ು ವ	O
ಸಮಯದಲ್ಲಿಯಾದರೂ ಸಮಯದಲ್ಲಿಯಾದರೂ	ಸ ಮ ಯ ದ ಲ ್ ಲ ಿ ಯ ಾ ದ ರ ೂ ಸ ಮ ಯ ದ ಲ ್ ಲ ಿ ಯ ಾ ದ ರ ೂ	O
ಉತ್ತೇಜಿಸುವ ಉತ್ತೇಜಿಸುವ	ಉ ತ ್ ತ ೇ ಜ ಿ ಸ ು ವ ಉ ತ ್ ತ ೇ ಜ ಿ ಸ ು ವ	O
ನಿವಾರಿಸಲ್ಪಟ್ಟಿತು ನಿವಾರಿಸಲ್ಪಟ್ಟಿತು	ನ ಿ ವ ಾ ರ ಿ ಸ ಲ ್ ಪ ಟ ್ ಟ ಿ ತ ು ನ ಿ ವ ಾ ರ ಿ ಸ ಲ ್ ಪ ಟ ್ ಟ ಿ ತ ು	O
ಕನ್ನಡ ಕನ್ನಡ	ಕ ನ ್ ನ ಡ ಕ ನ ್ ನ ಡ	O
ಉಜ್ವಲವಾದ ಉಜ್ವಲವಾದ	ಉ ಜ ್ ವ ಲ ವ ಾ ದ ಉ ಜ ್ ವ ಲ ವ ಾ ದ	O
	
ಹೊಸ ಹೊಸ	ಹ ೊ ಸ ಹ ೊ ಸ	O
ಪ್ರಾಗೈತಿಹಾಸಿಕ ಪ್ರಾಗೈತಿಹಾಸಿಕ	ಪ ್ ರ ಾ ಗ ೈ ತ ಿ ಹ ಾ ಸ ಿ ಕ ಪ ್ ರ ಾ ಗ ೈ ತ ಿ ಹ ಾ ಸ ಿ ಕ	O
, ,	, ,	O
ಸುಧಾರಣೆಗಳು ಸುಧಾರಣೆಗಳು	ಸ ು ಧ ಾ ರ ಣ ೆ ಗ ಳ ು ಸ ು ಧ ಾ ರ ಣ ೆ ಗ ಳ ು	O
ಸೇನಾಪಡೆಯನ್ನು ಸೇನಾಪಡೆಯನ್ನು	ಸ ೇ ನ ಾ ಪ ಡ ೆ ಯ ನ ್ ನ ು ಸ ೇ ನ ಾ ಪ ಡ ೆ ಯ ನ ್ ನ ು	O
ಮತ್ತು ಮತ್ತು	ಮ ತ ್ ತ ು ಮ ತ ್ ತ ು	O
ಶಾಸನದಲ್ಲಿ ಶಾಸನದಲ್ಲಿ	ಶ ಾ ಸ ನ ದ ಲ ್ ಲ ಿ ಶ ಾ ಸ ನ ದ ಲ ್ ಲ ಿ	O
ಮುಕ್ತಗೊಳಿಸಲು ಮುಕ್ತಗೊಳಿಸಲು	ಮ ು ಕ ್ ತ ಗ ೊ ಳ ಿ ಸ ಲ ು ಮ ು ಕ ್ ತ ಗ ೊ ಳ ಿ ಸ ಲ ು	O
ಮಧ್ಯಪ್ರದೇಶದ ಮಧ್ಯಪ್ರದೇಶದ	ಮ ಧ ್ ಯ ಪ ್ ರ ದ ೇ ಶ ದ ಮ ಧ ್ ಯ ಪ ್ ರ ದ ೇ ಶ ದ	B-LOC
ಎಂಬ ಎಂಬ	ಎ ಂ ಬ ಎ ಂ ಬ	O
ರಸ್ತೆ ರಸ್ತೆ	ರ ಸ ್ ತ ೆ ರ ಸ ್ ತ ೆ	O
9ನೆಯ 9ನೆಯ	9 ನ ೆ ಯ 9 ನ ೆ ಯ	TME
ಮತ್ತು ಮತ್ತು	ಮ ತ ್ ತ ು ಮ ತ ್ ತ ು	O
ಪ್ರತಿ ಪ್ರತಿ	ಪ ್ ರ ತ ಿ ಪ ್ ರ ತ ಿ	O
ಪದಾರ್ಥಗಳ ಪದಾರ್ಥಗಳ	ಪ ದ ಾ ರ ್ ಥ ಗ ಳ ಪ ದ ಾ ರ ್ ಥ ಗ ಳ	O
ಶಾಹುರೋಜ್ ಶಾಹುರೋಜ್	ಶ ಾ ಹ ು ರ ೋ ಜ ್ ಶ ಾ ಹ ು ರ ೋ ಜ ್	O
ತೀವ್ರವಾದಿಗಳಲ್ಲಿ ತೀವ್ರವಾದಿಗಳಲ್ಲಿ	ತ ೀ ವ ್ ರ ವ ಾ ದ ಿ ಗ ಳ ಲ ್ ಲ ಿ ತ ೀ ವ ್ ರ ವ ಾ ದ ಿ ಗ ಳ ಲ ್ ಲ ಿ	O
ಆದಿಲ್್ಶಾಹಿಗಳು ಆದಿಲ್್ಶಾಹಿಗಳು	ಆ ದ ಿ ಲ ್ ್ ಶ ಾ ಹ ಿ ಗ ಳ ು ಆ ದ ಿ ಲ ್ ್ ಶ ಾ ಹ ಿ ಗ ಳ ು	B-COM
ರಾಜಧಾನಿಯಾಗಿತ್ತೆಂದೂ ರಾಜಧಾನಿಯಾಗಿತ್ತೆಂದೂ	ರ ಾ ಜ ಧ ಾ ನ ಿ ಯ ಾ ಗ ಿ ತ ್ ತ ೆ ಂ ದ ೂ ರ ಾ ಜ ಧ ಾ ನ ಿ ಯ ಾ ಗ ಿ ತ ್ ತ ೆ ಂ ದ ೂ	O
ಸಾಕ್ರಟೀಸ್ ಸಾಕ್ರಟೀಸ್	ಸ ಾ ಕ ್ ರ ಟ ೀ ಸ ್ ಸ ಾ ಕ ್ ರ ಟ ೀ ಸ ್	B-PER
. .	. .	O
ಯಿತ್ರುಸ್ಕಾನರು ಯಿತ್ರುಸ್ಕಾನರು	ಯ ಿ ತ ್ ರ ು ಸ ್ ಕ ಾ ನ ರ ು ಯ ಿ ತ ್ ರ ು ಸ ್ ಕ ಾ ನ ರ ು	B-COM
ಅರಿಯಲು ಅರಿಯಲು	ಅ ರ ಿ ಯ ಲ ು ಅ ರ ಿ ಯ ಲ ು	O
ಬಾರಹತ್ ಬಾರಹತ್	ಬ ಾ ರ ಹ ತ ್ ಬ ಾ ರ ಹ ತ ್	O
ಆಗಾಗ ಆಗಾಗ	ಆ ಗ ಾ ಗ ಆ ಗ ಾ ಗ	O
ಉಪದೇಶ ಉಪದೇಶ	ಉ ಪ ದ ೇ ಶ ಉ ಪ ದ ೇ ಶ	O
, ,	, ,	O
ಮತ್ತು ಮತ್ತು	ಮ ತ ್ ತ ು ಮ ತ ್ ತ ು	O
ಸುಮಾರು ಸುಮಾರು	ಸ ು ಮ ಾ ರ ು ಸ ು ಮ ಾ ರ ು	O
. .	. .	O
. .	. .	O
ಸುಮಾರು ಸುಮಾರು	ಸ ು ಮ ಾ ರ ು ಸ ು ಮ ಾ ರ ು	O
ಪಯಣವು ಪಯಣವು	ಪ ಯ ಣ ವ ು ಪ ಯ ಣ ವ ು	O
ಗೋಡೆಯೊಂದನ್ನು ಗೋಡೆಯೊಂದನ್ನು	ಗ ೋ ಡ ೆ ಯ ೊ ಂ ದ ನ ್ ನ ು ಗ ೋ ಡ ೆ ಯ ೊ ಂ ದ ನ ್ ನ ು	O
ಇದನ್ನೇ ಇದನ್ನೇ	ಇ ದ ನ ್ ನ ೆ ೕ ಇ ದ ನ ್ ನ ೆ ೕ	O
	
	
	
, ,	, ,	O
. .	. .	O
ಪರ್ಷಿಯನ್ ಪರ್ಷಿಯನ್	ಪ ರ ್ ಷ ಿ ಯ ನ ್ ಪ ರ ್ ಷ ಿ ಯ ನ ್	 LOC
ನಡೆಯುತ್ತಿದ್ದ ನಡೆಯುತ್ತಿದ್ದ	ನ ಡ ೆ ಯ ು ತ ್ ತ ಿ ದ ್ ದ ನ ಡ ೆ ಯ ು ತ ್ ತ ಿ ದ ್ ದ	O
	
ಆಗಮಿಸುತ್ತಿದ್ದಂತೆಯೇ ಆಗಮಿಸುತ್ತಿದ್ದಂತೆಯೇ	ಆ ಗ ಮ ಿ ಸ ು ತ ್ ತ ಿ ದ ್ ದ ಂ ತ ೆ ಯ ೇ ಆ ಗ ಮ ಿ ಸ ು ತ ್ ತ ಿ ದ ್ ದ ಂ ತ ೆ ಯ ೇ	O
ಪ್ರಯೋಗಗಳನ್ನು ಪ್ರಯೋಗಗಳನ್ನು	ಪ ್ ರ ಯ ೋ ಗ ಗ ಳ ನ ್ ನ ು ಪ ್ ರ ಯ ೋ ಗ ಗ ಳ ನ ್ ನ ು	O
ಸಿಲುಕಿ ಸಿಲುಕಿ	ಸ ಿ ಲ ು ಕ ಿ ಸ ಿ ಲ ು ಕ ಿ	O
. .	. .	O
ಕುಹಕ ಕುಹಕ	ಕ ು ಹ ಕ ಕ ು ಹ ಕ	O
ನಡೆದಿದೆ ನಡೆದಿದೆ	ನ ಡ ೆ ದ ಿ ದ ೆ ನ ಡ ೆ ದ ಿ ದ ೆ	O
ದೇಸಾಯಿಗೆ ದೇಸಾಯಿಗೆ	ದ ೇ ಸ ಾ ಯ ಿ ಗ ೆ ದ ೇ ಸ ಾ ಯ ಿ ಗ ೆ	 PER
ಮತೀಯ ಮತೀಯ	ಮ ತ ೀ ಯ ಮ ತ ೀ ಯ	O
ಕಾಮನ್ಸ್ ಕಾಮನ್ಸ್	ಕ ಾ ಮ ನ ್ ಸ ್ ಕ ಾ ಮ ನ ್ ಸ ್	O
ಮೈಸೂರು ಮೈಸೂರು	ಮ ೈ ಸ ೂ ರ ು ಮ ೈ ಸ ೂ ರ ು	B-LOC
ಬೆಳೆಸಿದರು ಬೆಳೆಸಿದರು	ಬ ೆ ಳ ೆ ಸ ಿ ದ ರ ು ಬ ೆ ಳ ೆ ಸ ಿ ದ ರ ು	O
	
ಮುಖಂಡತ್ವದಲ್ಲಿ ಮುಖಂಡತ್ವದಲ್ಲಿ	ಮ ು ಖ ಂ ಡ ತ ್ ವ ದ ಲ ್ ಲ ಿ ಮ ು ಖ ಂ ಡ ತ ್ ವ ದ ಲ ್ ಲ ಿ	O
, ,	, ,	O
ನೀಡಿದರು ನೀಡಿದರು	ನ ೀ ಡ ಿ ದ ರ ು ನ ೀ ಡ ಿ ದ ರ ು	O
ಪ್ರದೇಶಗಳ ಪ್ರದೇಶಗಳ	ಪ ್ ರ ದ ೇ ಶ ಗ ಳ ಪ ್ ರ ದ ೇ ಶ ಗ ಳ	O
ಆದರು ಆದರು	ಆ ದ ರ ು ಆ ದ ರ ು	O
ಸಹಾಯ ಸಹಾಯ	ಸ ಹ ಾ ಯ ಸ ಹ ಾ ಯ	O
ಹೆಚ್ಚು ಹೆಚ್ಚು	ಹ ೆ ಚ ್ ಚ ು ಹ ೆ ಚ ್ ಚ ು	O
ಇಂಡಿಯ ಇಂಡಿಯ	ಇ ಂ ಡ ಿ ಯ ಇ ಂ ಡ ಿ ಯ	ORG
ಜಲಚರಗಳ ಜಲಚರಗಳ	ಜ ಲ ಚ ರ ಗ ಳ ಜ ಲ ಚ ರ ಗ ಳ	O
ತನ್ನ ತನ್ನ	ತ ನ ್ ನ ತ ನ ್ ನ	O
ಅವನ ಅವನ	ಅ ವ ನ ಅ ವ ನ	O
ಕೆಳಕಂಡ ಕೆಳಕಂಡ	ಕ ೆ ಳ ಕ ಂ ಡ ಕ ೆ ಳ ಕ ಂ ಡ	O
. .	. .	O
ಸ್ವಾಗತಾಧ್ಯಕ್ಷರಾಗಿದ್ದವರು ಸ್ವಾಗತಾಧ್ಯಕ್ಷರಾಗಿದ್ದವರು	ಸ ್ ವ ಾ ಗ ತ ಾ ಧ ್ ಯ ಕ ್ ಷ ರ ಾ ಗ ಿ ದ ್ ದ ವ ರ ು ಸ ್ ವ ಾ ಗ ತ ಾ ಧ ್ ಯ ಕ ್ ಷ ರ ಾ ಗ ಿ ದ ್ ದ ವ ರ ು	B-ROL
ಬ್ರಹ್ಮ ಬ್ರಹ್ಮ	ಬ ್ ರ ಹ ್ ಮ ಬ ್ ರ ಹ ್ ಮ	B-PER
ಲಾಲ್ಬಾಗ್ ಲಾಲ್ಬಾಗ್	ಲ ಾ ಲ ್ ಬ ಾ ಗ ್ ಲ ಾ ಲ ್ ಬ ಾ ಗ ್	B-LOC
ಅನೈಕ್ಯದಿಂದಾಗಿ ಅನೈಕ್ಯದಿಂದಾಗಿ	ಅ ನ ೈ ಕ ್ ಯ ದ ಿ ಂ ದ ಾ ಗ ಿ ಅ ನ ೈ ಕ ್ ಯ ದ ಿ ಂ ದ ಾ ಗ ಿ	O
ಪ್ರಾಮುಖ್ಯತೆಗೆ ಪ್ರಾಮುಖ್ಯತೆಗೆ	ಪ ್ ರ ಾ ಮ ು ಖ ್ ಯ ತ ೆ ಗ ೆ ಪ ್ ರ ಾ ಮ ು ಖ ್ ಯ ತ ೆ ಗ ೆ	O
ಕಾಲದ ಕಾಲದ	ಕ ಾ ಲ ದ ಕ ಾ ಲ ದ	O
ರಾಜ ರಾಜ	ರ ಾ ಜ ರ ಾ ಜ	B-ROL
ಸಾಮ್ರಾಜ್ಯದ ಸಾಮ್ರಾಜ್ಯದ	ಸ ಾ ಮ ್ ರ ಾ ಜ ್ ಯ ದ ಸ ಾ ಮ ್ ರ ಾ ಜ ್ ಯ ದ	O
ಜಾರಿಯಲ್ಲಿ ಜಾರಿಯಲ್ಲಿ	ಜ ಾ ರ ಿ ಯ ಲ ್ ಲ ಿ ಜ ಾ ರ ಿ ಯ ಲ ್ ಲ ಿ	O
ಮಧ್ಯಪ್ರದೇಶ ಮಧ್ಯಪ್ರದೇಶ	ಮ ಧ ್ ಯ ಪ ್ ರ ದ ೇ ಶ ಮ ಧ ್ ಯ ಪ ್ ರ ದ ೇ ಶ	B-LOC
ತರಗುಪೇಟೆ ತರಗುಪೇಟೆ	ತ ರ ಗ ು ಪ ೇ ಟ ೆ ತ ರ ಗ ು ಪ ೇ ಟ ೆ	B-LOC
ಪುತ್ತಿಗೆ ಪುತ್ತಿಗೆ	ಪ ು ತ ್ ತ ಿ ಗ ೆ ಪ ು ತ ್ ತ ಿ ಗ ೆ	O
ನಡೆದುಕೊಂಡು ನಡೆದುಕೊಂಡು	ನ ಡ ೆ ದ ು ಕ ೊ ಂ ಡ ು ನ ಡ ೆ ದ ು ಕ ೊ ಂ ಡ ು	O
ಚಳುವಳಿ ಚಳುವಳಿ	ಚ ಳ ು ವ ಳ ಿ ಚ ಳ ು ವ ಳ ಿ	O
ಮೂರನೆಯ ಮೂರನೆಯ	ಮ ೂ ರ ನ ೆ ಯ ಮ ೂ ರ ನ ೆ ಯ	B-PER
ಉಳಿಗಮಾನ್ಯ ಉಳಿಗಮಾನ್ಯ	ಉ ಳ ಿ ಗ ಮ ಾ ನ ್ ಯ ಉ ಳ ಿ ಗ ಮ ಾ ನ ್ ಯ	O
ಕಾಳಿದಾಸನ ಕಾಳಿದಾಸನ	ಕ ಾ ಳ ಿ ದ ಾ ಸ ನ ಕ ಾ ಳ ಿ ದ ಾ ಸ ನ	B-PER
ಪ್ರತಾಪ್ ಪ್ರತಾಪ್	ಪ ್ ರ ತ ಾ ಪ ್ ಪ ್ ರ ತ ಾ ಪ ್	B-PER
	
ಧಾರ್ಮಿಕ ಧಾರ್ಮಿಕ	ಧ ಾ ರ ್ ಮ ಿ ಕ ಧ ಾ ರ ್ ಮ ಿ ಕ	O
ಅಂತಹ ಅಂತಹ	ಅ ಂ ತ ಹ ಅ ಂ ತ ಹ	O
ಅಲೀಖಾನ ಅಲೀಖಾನ	ಅ ಲ ೀ ಖ ಾ ನ ಅ ಲ ೀ ಖ ಾ ನ	 PER
, ,	, ,	O
ರಲ್ಲಿ ರಲ್ಲಿ	ರ ಲ ್ ಲ ಿ ರ ಲ ್ ಲ ಿ	O
ಮುಳ್ಳಿನ ಮುಳ್ಳಿನ	ಮ ು ಳ ್ ಳ ಿ ನ ಮ ು ಳ ್ ಳ ಿ ನ	O
ಶಾಸ್ತ್ರಗ್ರಂಥವಾಗಿರುವದು ಶಾಸ್ತ್ರಗ್ರಂಥವಾಗಿರುವದು	ಶ ಾ ಸ ್ ತ ್ ರ ಗ ್ ರ ಂ ಥ ವ ಾ ಗ ಿ ರ ು ವ ದ ು ಶ ಾ ಸ ್ ತ ್ ರ ಗ ್ ರ ಂ ಥ ವ ಾ ಗ ಿ ರ ು ವ ದ ು	O
ತನ್ನ ತನ್ನ	ತ ನ ್ ನ ತ ನ ್ ನ	O
ಮಾಡಿದ ಮಾಡಿದ	ಮ ಾ ಡ ಿ ದ ಮ ಾ ಡ ಿ ದ	O
ಕೈಗೊಂಡನು ಕೈಗೊಂಡನು	ಕ ೈ ಗ ೊ ಂ ಡ ನ ು ಕ ೈ ಗ ೊ ಂ ಡ ನ ು	O
ಆಳುವವರ ಆಳುವವರ	ಆ ಳ ು ವ ವ ರ ಆ ಳ ು ವ ವ ರ	O
ಇವನು ಇವನು	ಇ ವ ನ ು ಇ ವ ನ ು	O
ನಗರ ನಗರ	ನ ಗ ರ ನ ಗ ರ	 LOC
ಮುಖ್ಯ ಮುಖ್ಯ	ಮ ು ಖ ್ ಯ ಮ ು ಖ ್ ಯ	O
ಎಂದರ್ಥ ಎಂದರ್ಥ	ಎ ಂ ದ ರ ್ ಥ ಎ ಂ ದ ರ ್ ಥ	O
ಮತ್ತು ಮತ್ತು	ಮ ತ ್ ತ ು ಮ ತ ್ ತ ು	O
ಪ್ರತಾಪ ಪ್ರತಾಪ	ಪ ್ ರ ತ ಾ ಪ ಪ ್ ರ ತ ಾ ಪ	 PER
ಸಂಘಟಿಸಲು ಸಂಘಟಿಸಲು	ಸ ಂ ಘ ಟ ಿ ಸ ಲ ು ಸ ಂ ಘ ಟ ಿ ಸ ಲ ು	O
ನಗರಗಳು ನಗರಗಳು	ನ ಗ ರ ಗ ಳ ು ನ ಗ ರ ಗ ಳ ು	O
. .	. .	O
. .	. .	O
ನೋಡಿಕೊಳ್ಳುತ್ತಿದ್ದವನನ್ನು ನೋಡಿಕೊಳ್ಳುತ್ತಿದ್ದವನನ್ನು	ನ ೋ ಡ ಿ ಕ ೊ ಳ ್ ಳ ು ತ ್ ತ ಿ ದ ್ ದ ವ ನ ನ ್ ನ ು ನ ೋ ಡ ಿ ಕ ೊ ಳ ್ ಳ ು ತ ್ ತ ಿ ದ ್ ದ ವ ನ ನ ್ ನ ು	O
ರಾಜಕುಮಾರರಂತೆ ರಾಜಕುಮಾರರಂತೆ	ರ ಾ ಜ ಕ ು ಮ ಾ ರ ರ ಂ ತ ೆ ರ ಾ ಜ ಕ ು ಮ ಾ ರ ರ ಂ ತ ೆ	O
ವರ್ಣಿಸಲಾಗಿದೆ ವರ್ಣಿಸಲಾಗಿದೆ	ವ ರ ್ ಣ ಿ ಸ ಲ ಾ ಗ ಿ ದ ೆ ವ ರ ್ ಣ ಿ ಸ ಲ ಾ ಗ ಿ ದ ೆ	O
ಪಠಾನ್ ಪಠಾನ್	ಪ ಠ ಾ ನ ್ ಪ ಠ ಾ ನ ್	 PER
ಇದಕ್ಕೆ ಇದಕ್ಕೆ	ಇ ದ ಕ ್ ಕ ೆ ಇ ದ ಕ ್ ಕ ೆ	O
	
	
ವಿಳಂದ ವಿಳಂದ	ವ ಿ ಳ ಂ ದ ವ ಿ ಳ ಂ ದ	B-LOC
ಕನಿಷ್ಟ ಕನಿಷ್ಟ	ಕ ನ ಿ ಷ ್ ಟ ಕ ನ ಿ ಷ ್ ಟ	O
ಪೂರ್ವ ಪೂರ್ವ	ಪ ೂ ರ ್ ವ ಪ ೂ ರ ್ ವ	 LOC
ಕದನದಲ್ಲಿ ಕದನದಲ್ಲಿ	ಕ ದ ನ ದ ಲ ್ ಲ ಿ ಕ ದ ನ ದ ಲ ್ ಲ ಿ	O
, ,	, ,	O
ಧಾರ್ಮಿಕ ಧಾರ್ಮಿಕ	ಧ ಾ ರ ್ ಮ ಿ ಕ ಧ ಾ ರ ್ ಮ ಿ ಕ	O
ತರುವಲ್ಲಿ ತರುವಲ್ಲಿ	ತ ರ ು ವ ಲ ್ ಲ ಿ ತ ರ ು ವ ಲ ್ ಲ ಿ	O
ಆಲಂಪುರ ಆಲಂಪುರ	ಆ ಲ ಂ ಪ ು ರ ಆ ಲ ಂ ಪ ು ರ	 LOC
	
ಪ್ರದೇಶಗಳ ಪ್ರದೇಶಗಳ	ಪ ್ ರ ದ ೇ ಶ ಗ ಳ ಪ ್ ರ ದ ೇ ಶ ಗ ಳ	O
ಶೈಲಿಯ ಶೈಲಿಯ	ಶ ೈ ಲ ಿ ಯ ಶ ೈ ಲ ಿ ಯ	O
, ,	, ,	O
ಶ್ರೀವಲ್ಲಭ ಶ್ರೀವಲ್ಲಭ	ಶ ್ ರ ೀ ವ ಲ ್ ಲ ಭ ಶ ್ ರ ೀ ವ ಲ ್ ಲ ಭ	 PER
ಆದ್ದರಿಂದ ಆದ್ದರಿಂದ	ಆ ದ ್ ದ ರ ಿ ಂ ದ ಆ ದ ್ ದ ರ ಿ ಂ ದ	O
ತಿಳಿಯಲು ತಿಳಿಯಲು	ತ ಿ ಳ ಿ ಯ ಲ ು ತ ಿ ಳ ಿ ಯ ಲ ು	O
ಚಿತ್ರವು ಚಿತ್ರವು	ಚ ಿ ತ ್ ರ ವ ು ಚ ಿ ತ ್ ರ ವ ು	O
ಇದರ ಇದರ	ಇ ದ ರ ಇ ದ ರ	O
ನಿರ್ಮಿಸಿ ನಿರ್ಮಿಸಿ	ನ ಿ ರ ್ ಮ ಿ ಸ ಿ ನ ಿ ರ ್ ಮ ಿ ಸ ಿ	O
ಪ್ರತಿಕೂಲ ಪ್ರತಿಕೂಲ	ಪ ್ ರ ತ ಿ ಕ ೂ ಲ ಪ ್ ರ ತ ಿ ಕ ೂ ಲ	O
ಗೋದಾವರಿ ಗೋದಾವರಿ	ಗ ೋ ದ ಾ ವ ರ ಿ ಗ ೋ ದ ಾ ವ ರ ಿ	B-LOC
ಕರ್ನಲ್ ಕರ್ನಲ್	ಕ ರ ್ ನ ಲ ್ ಕ ರ ್ ನ ಲ ್	B-ROL
6 6	6
	
ಕ್ರಮಗಳನ್ನು ಕ್ರಮಗಳನ್ನು	ಕ ್ ರ ಮ ಗ ಳ ನ ್ ನ ು ಕ ್ ರ ಮ ಗ ಳ ನ ್ ನ ು	O
ಸಿದ್ಧತೆ ಸಿದ್ಧತೆ	ಸ ಿ ದ ್ ಧ ತ ೆ ಸ ಿ ದ ್ ಧ ತ ೆ	O
ಭಾರತದ ಭಾರತದ	ಭ ಾ ರ ತ ದ ಭ ಾ ರ ತ ದ	 LOC
ಭಾರತದ ಭಾರತದ	ಭ ಾ ರ ತ ದ ಭ ಾ ರ ತ ದ	B-LOC
ಷಾ ಷಾ	ಷ ಾ ಷ ಾ	 PER
ಅವುಗಳನ್ನು ಅವುಗಳನ್ನು	ಅ ವ ು ಗ ಳ ನ ್ ನ ು ಅ ವ ು ಗ ಳ ನ ್ ನ ು	O
ಪಶ್ಚಿಮದಲ್ಲಿ ಪಶ್ಚಿಮದಲ್ಲಿ	ಪ ಶ ್ ಚ ಿ ಮ ದ ಲ ್ ಲ ಿ ಪ ಶ ್ ಚ ಿ ಮ ದ ಲ ್ ಲ ಿ	 LOC
. .	. .	O
ಆತನನ್ನು ಆತನನ್ನು	ಆ ತ ನ ನ ್ ನ ು ಆ ತ ನ ನ ್ ನ ು	O
ಹೈದರ್ ಹೈದರ್	ಹ ೈ ದ ರ ್ ಹ ೈ ದ ರ ್	B-PER
ಗುರಿಗಳನ್ನು ಗುರಿಗಳನ್ನು	ಗ ು ರ ಿ ಗ ಳ ನ ್ ನ ು ಗ ು ರ ಿ ಗ ಳ ನ ್ ನ ು	O
ಕಾಲವಿತ್ತು ಕಾಲವಿತ್ತು	ಕ ಾ ಲ ವ ಿ ತ ್ ತ ು ಕ ಾ ಲ ವ ಿ ತ ್ ತ ು	O
	
ಯನ್ನು ಯನ್ನು	ಯ ನ ್ ನ ು ಯ ನ ್ ನ ು	O
ತಾಯಿಗೆ ತಾಯಿಗೆ	ತ ಾ ಯ ಿ ಗ ೆ ತ ಾ ಯ ಿ ಗ ೆ	O
ತೀವ್ರ ತೀವ್ರ	ತ ೀ ವ ್ ರ ತ ೀ ವ ್ ರ	O
ಕ್ಲೇಮೇಟ್ ಕ್ಲೇಮೇಟ್	ಕ ್ ಲ ೇ ಮ ೇ ಟ ್ ಕ ್ ಲ ೇ ಮ ೇ ಟ ್	B-PER
ಸಂಪಾದಿಸಿದನು ಸಂಪಾದಿಸಿದನು	ಸ ಂ ಪ ಾ ದ ಿ ಸ ಿ ದ ನ ು ಸ ಂ ಪ ಾ ದ ಿ ಸ ಿ ದ ನ ು	O
	
. .	. .	O
ಬಹುಸಂಖ್ಯೆಯಲ್ಲಿದ್ದರು ಬಹುಸಂಖ್ಯೆಯಲ್ಲಿದ್ದರು	ಬ ಹ ು ಸ ಂ ಖ ್ ಯ ೆ ಯ ಲ ್ ಲ ಿ ದ ್ ದ ರ ು ಬ ಹ ು ಸ ಂ ಖ ್ ಯ ೆ ಯ ಲ ್ ಲ ಿ ದ ್ ದ ರ ು	O
ಸಮಾನ ಸಮಾನ	ಸ ಮ ಾ ನ ಸ ಮ ಾ ನ	O
	
	
ಹೊರಗಟ್ಟಲು ಹೊರಗಟ್ಟಲು	ಹ ೊ ರ ಗ ಟ ್ ಟ ಲ ು ಹ ೊ ರ ಗ ಟ ್ ಟ ಲ ು	O
ಪರಿಣಾಮಗಳನ್ನು ಪರಿಣಾಮಗಳನ್ನು	ಪ ರ ಿ ಣ ಾ ಮ ಗ ಳ ನ ್ ನ ು ಪ ರ ಿ ಣ ಾ ಮ ಗ ಳ ನ ್ ನ ು	O
. .	. .	O
ಮತ್ತೆ ಮತ್ತೆ	ಮ ತ ್ ತ ೆ ಮ ತ ್ ತ ೆ	O
ವಿಕ್ಟೋರಿಯಾಳು ವಿಕ್ಟೋರಿಯಾಳು	ವ ಿ ಕ ್ ಟ ೋ ರ ಿ ಯ ಾ ಳ ು ವ ಿ ಕ ್ ಟ ೋ ರ ಿ ಯ ಾ ಳ ು	B-PER
ಗೋವಿಂದನ ಗೋವಿಂದನ	ಗ ೋ ವ ಿ ಂ ದ ನ ಗ ೋ ವ ಿ ಂ ದ ನ	 PER
	
ಹಾಗೆಯೇ ಹಾಗೆಯೇ	ಹ ಾ ಗ ೆ ಯ ೇ ಹ ಾ ಗ ೆ ಯ ೇ	O
. .	. .	O
ಒಕ್ಕೂಟಕ್ಕೆ ಒಕ್ಕೂಟಕ್ಕೆ	ಒ ಕ ್ ಕ ೂ ಟ ಕ ್ ಕ ೆ ಒ ಕ ್ ಕ ೂ ಟ ಕ ್ ಕ ೆ	O
ವ್ಯವಸ್ಥಿತವಾಗಿ ವ್ಯವಸ್ಥಿತವಾಗಿ	ವ ್ ಯ ವ ಸ ್ ಥ ಿ ತ ವ ಾ ಗ ಿ ವ ್ ಯ ವ ಸ ್ ಥ ಿ ತ ವ ಾ ಗ ಿ	O
ವರ್ಷ ವರ್ಷ	ವ ರ ್ ಷ ವ ರ ್ ಷ	TME
ಈ ಈ	ಈ ಈ	O
ಉಡುಗೊರೆಗಳನ್ನು ಉಡುಗೊರೆಗಳನ್ನು	ಉ ಡ ು ಗ ೊ ರ ೆ ಗ ಳ ನ ್ ನ ು ಉ ಡ ು ಗ ೊ ರ ೆ ಗ ಳ ನ ್ ನ ು	O
ಸಾಕಷ್ಟು ಸಾಕಷ್ಟು	ಸ ಾ ಕ ಷ ್ ಟ ು ಸ ಾ ಕ ಷ ್ ಟ ು	O
. .	. .	O
ಬಲ್ಲಾಳನು ಬಲ್ಲಾಳನು	ಬ ಲ ್ ಲ ಾ ಳ ನ ು ಬ ಲ ್ ಲ ಾ ಳ ನ ು	 PER
ಬೀರಿದ್ದವು ಬೀರಿದ್ದವು	ಬ ೀ ರ ಿ ದ ್ ದ ವ ು ಬ ೀ ರ ಿ ದ ್ ದ ವ ು	O
, ,	, ,	O
ಅವು ಅವು	ಅ ವ ು ಅ ವ ು	O
. .	. .	O
ತನ್ನ ತನ್ನ	ತ ನ ್ ನ ತ ನ ್ ನ	O
ವಿದ್ವಾಂಸರು ವಿದ್ವಾಂಸರು	ವ ಿ ದ ್ ವ ಾ ಂ ಸ ರ ು ವ ಿ ದ ್ ವ ಾ ಂ ಸ ರ ು	B-ROL
ಕಾಯ್ದೆಯ ಕಾಯ್ದೆಯ	ಕ ಾ ಯ ್ ದ ೆ ಯ ಕ ಾ ಯ ್ ದ ೆ ಯ	O
ವ್ಯಾಖ್ಯಾನಗಳು ವ್ಯಾಖ್ಯಾನಗಳು	ವ ್ ಯ ಾ ಖ ್ ಯ ಾ ನ ಗ ಳ ು ವ ್ ಯ ಾ ಖ ್ ಯ ಾ ನ ಗ ಳ ು	O
, ,	, ,	O
ಆಗಲಿಲ್ಲ ಆಗಲಿಲ್ಲ	ಆ ಗ ಲ ಿ ಲ ್ ಲ ಆ ಗ ಲ ಿ ಲ ್ ಲ	O
ಅತ್ಯುತ್ತಮ ಅತ್ಯುತ್ತಮ	ಅ ತ ್ ಯ ು ತ ್ ತ ಮ ಅ ತ ್ ಯ ು ತ ್ ತ ಮ	O
ಪಟ್ಟಾಭಿಷಿಕ್ತನಾದ ಪಟ್ಟಾಭಿಷಿಕ್ತನಾದ	ಪ ಟ ್ ಟ ಾ ಭ ಿ ಷ ಿ ಕ ್ ತ ನ ಾ ದ ಪ ಟ ್ ಟ ಾ ಭ ಿ ಷ ಿ ಕ ್ ತ ನ ಾ ದ	O
. .	. .	O
	
	
ಆದರೆ ಆದರೆ	ಆ ದ ರ ೆ ಆ ದ ರ ೆ	O
. .	. .	O
ಸರ್ಕಾರ ಸರ್ಕಾರ	ಸ ರ ್ ಕ ಾ ರ ಸ ರ ್ ಕ ಾ ರ	I-COM
ಮುಂತಾದವರಿಗೂ ಮುಂತಾದವರಿಗೂ	ಮ ು ಂ ತ ಾ ದ ವ ರ ಿ ಗ ೂ ಮ ು ಂ ತ ಾ ದ ವ ರ ಿ ಗ ೂ	O
ಗಮನವನ್ನು ಗಮನವನ್ನು	ಗ ಮ ನ ವ ನ ್ ನ ು ಗ ಮ ನ ವ ನ ್ ನ ು	O
ನಕ್ಷತ್ರಾಕಾರದ ನಕ್ಷತ್ರಾಕಾರದ	ನ ಕ ್ ಷ ತ ್ ರ ಾ ಕ ಾ ರ ದ ನ ಕ ್ ಷ ತ ್ ರ ಾ ಕ ಾ ರ ದ	O
. .	. .	O
ಮಾಡುವವರನ್ನು ಮಾಡುವವರನ್ನು	ಮ ಾ ಡ ು ವ ವ ರ ನ ್ ನ ು ಮ ಾ ಡ ು ವ ವ ರ ನ ್ ನ ು	O
ಚಿತೆ್ತೕಡ ಚಿತೆ್ತೕಡ	ಚ ಿ ತ ೆ ್ ತ ೕ ಡ ಚ ಿ ತ ೆ ್ ತ ೕ ಡ	B-LOC
ಬಂದು ಬಂದು	ಬ ಂ ದ ು ಬ ಂ ದ ು	O
ತಡೆಯುವ ತಡೆಯುವ	ತ ಡ ೆ ಯ ು ವ ತ ಡ ೆ ಯ ು ವ	O
ಸಾಮಾಜಿಕ ಸಾಮಾಜಿಕ	ಸ ಾ ಮ ಾ ಜ ಿ ಕ ಸ ಾ ಮ ಾ ಜ ಿ ಕ	O
ಕಾರಣವಾದ ಕಾರಣವಾದ	ಕ ಾ ರ ಣ ವ ಾ ದ ಕ ಾ ರ ಣ ವ ಾ ದ	O
ಮಹದೇವಾಲಯವನ್ನು ಮಹದೇವಾಲಯವನ್ನು	ಮ ಹ ದ ೇ ವ ಾ ಲ ಯ ವ ನ ್ ನ ು ಮ ಹ ದ ೇ ವ ಾ ಲ ಯ ವ ನ ್ ನ ು	O
75ರ 75ರ	7 5 ರ
. .	. .	O
ಅದು ಅದು	ಅ ದ ು ಅ ದ ು	O
ಭಾರತೀಯ ಭಾರತೀಯ	ಭ ಾ ರ ತ ೀ ಯ ಭ ಾ ರ ತ ೀ ಯ	B-LOC
ವಿರುದ್ಧ ವಿರುದ್ಧ	ವ ಿ ರ ು ದ ್ ಧ ವ ಿ ರ ು ದ ್ ಧ	O
ಶಾಖೆಗಳನ್ನು ಶಾಖೆಗಳನ್ನು	ಶ ಾ ಖ ೆ ಗ ಳ ನ ್ ನ ು ಶ ಾ ಖ ೆ ಗ ಳ ನ ್ ನ ು	ORG
ಎಂಬ ಎಂಬ	ಎ ಂ ಬ ಎ ಂ ಬ	O
. .	. .	O
ಜಲಿಯನ್ವಾಲಾಬಾಗ್ ಜಲಿಯನ್ವಾಲಾಬಾಗ್	ಜ ಲ ಿ ಯ ನ ್ ವ ಾ ಲ ಾ ಬ ಾ ಗ ್ ಜ ಲ ಿ ಯ ನ ್ ವ ಾ ಲ ಾ ಬ ಾ ಗ ್	B-LOC
, ,	, ,	O
, ,	, ,	O
. .	. .	O
ವ್ಯವಸ್ಥೆ ವ್ಯವಸ್ಥೆ	ವ ್ ಯ ವ ಸ ್ ಥ ೆ ವ ್ ಯ ವ ಸ ್ ಥ ೆ	O
ಅದರಲ್ಲೂ ಅದರಲ್ಲೂ	ಅ ದ ರ ಲ ್ ಲ ೂ ಅ ದ ರ ಲ ್ ಲ ೂ	O
ಲೆಫ್ಟಿನೆಂಟ್ ಲೆಫ್ಟಿನೆಂಟ್	ಲ ೆ ಫ ್ ಟ ಿ ನ ೆ ಂ ಟ ್ ಲ ೆ ಫ ್ ಟ ಿ ನ ೆ ಂ ಟ ್	B-ROL
ಪಲ್ಲವರೊಂದಿಗಿನ ಪಲ್ಲವರೊಂದಿಗಿನ	ಪ ಲ ್ ಲ ವ ರ ೊ ಂ ದ ಿ ಗ ಿ ನ ಪ ಲ ್ ಲ ವ ರ ೊ ಂ ದ ಿ ಗ ಿ ನ	B-COM
೧೯೪೬ ೧೯೪೬	೧ ೯ ೪ ೬ ೧ ೯ ೪ ೬	TME
ಮತ್ತು ಮತ್ತು	ಮ ತ ್ ತ ು ಮ ತ ್ ತ ು	O
. .	. .	O
. .	. .	O
. .	. .	O
ಪ್ರಕಾರ ಪ್ರಕಾರ	ಪ ್ ರ ಕ ಾ ರ ಪ ್ ರ ಕ ಾ ರ	O
. .	. .	O
ಕಲಿಸಿ ಕಲಿಸಿ	ಕ ಲ ಿ ಸ ಿ ಕ ಲ ಿ ಸ ಿ	O
. .	. .	O
ಹಾಗೂ ಹಾಗೂ	ಹ ಾ ಗ ೂ ಹ ಾ ಗ ೂ	O
ನಿಟ್ಟಿನಲ್ಲಿ ನಿಟ್ಟಿನಲ್ಲಿ	ನ ಿ ಟ ್ ಟ ಿ ನ ಲ ್ ಲ ಿ ನ ಿ ಟ ್ ಟ ಿ ನ ಲ ್ ಲ ಿ	O
ಎಪ್ರಿಲ್ ಎಪ್ರಿಲ್	ಎ ಪ ್ ರ ಿ ಲ ್ ಎ ಪ ್ ರ ಿ ಲ ್	O
ಭಾರತವು ಭಾರತವು	ಭ ಾ ರ ತ ವ ು ಭ ಾ ರ ತ ವ ು	B-LOC
ಸಹ ಸಹ	ಸ ಹ ಸ ಹ	O
ಮಾತನಾಡಿ ಮಾತನಾಡಿ	ಮ ಾ ತ ನ ಾ ಡ ಿ ಮ ಾ ತ ನ ಾ ಡ ಿ	O
ನಿರಂಕುಶ ನಿರಂಕುಶ	ನ ಿ ರ ಂ ಕ ು ಶ ನ ಿ ರ ಂ ಕ ು ಶ	O
ಮಾಡದೆ ಮಾಡದೆ	ಮ ಾ ಡ ದ ೆ ಮ ಾ ಡ ದ ೆ	O
ಎಂಬ ಎಂಬ	ಎ ಂ ಬ ಎ ಂ ಬ	O
ಮತ್ತು ಮತ್ತು	ಮ ತ ್ ತ ು ಮ ತ ್ ತ ು	O
ನಂ ನಂ	ನ ಂ ನ ಂ	O
ಕದನದಲ್ಲಿ ಕದನದಲ್ಲಿ	ಕ ದ ನ ದ ಲ ್ ಲ ಿ ಕ ದ ನ ದ ಲ ್ ಲ ಿ	O
ಚೆನ್ನಮ್ಮಾಜಿ ಚೆನ್ನಮ್ಮಾಜಿ	ಚ ೆ ನ ್ ನ ಮ ್ ಮ ಾ ಜ ಿ ಚ ೆ ನ ್ ನ ಮ ್ ಮ ಾ ಜ ಿ	B-PER
ಸೈನ್ಯ ಸೈನ್ಯ	ಸ ೈ ನ ್ ಯ ಸ ೈ ನ ್ ಯ	O
. .	. .	O
ನಾಟಿದ್ದರಿಂದ ನಾಟಿದ್ದರಿಂದ	ನ ಾ ಟ ಿ ದ ್ ದ ರ ಿ ಂ ದ ನ ಾ ಟ ಿ ದ ್ ದ ರ ಿ ಂ ದ	O
ಒಂದು ಒಂದು	ಒ ಂ ದ ು
೧೯೪೮ ೧೯೪೮	೧ ೯ ೪ ೮ ೧ ೯ ೪ ೮	TME
ಗ್ಯಾಲನ್ಗಳಷ್ಟಿದೆ ಗ್ಯಾಲನ್ಗಳಷ್ಟಿದೆ	ಗ ್ ಯ ಾ ಲ ನ ್ ಗ ಳ ಷ ್ ಟ ಿ ದ ೆ ಗ ್ ಯ ಾ ಲ ನ ್ ಗ ಳ ಷ ್ ಟ ಿ ದ ೆ	O
. .	. .	O
ಆಕಸ್ಮಿಕ ಆಕಸ್ಮಿಕ	ಆ ಕ ಸ ್ ಮ ಿ ಕ ಆ ಕ ಸ ್ ಮ ಿ ಕ	O
ಸುಮಾರು ಸುಮಾರು	ಸ ು ಮ ಾ ರ ು ಸ ು ಮ ಾ ರ ು	O
	
ಕಾಲದ ಕಾಲದ	ಕ ಾ ಲ ದ ಕ ಾ ಲ ದ	O
ಶಿಕ್ಷಣ ಶಿಕ್ಷಣ	ಶ ಿ ಕ ್ ಷ ಣ ಶ ಿ ಕ ್ ಷ ಣ	O
	
ಅ಩ೇಕ ಅ಩ೇಕ	ಅ ಩ ೇ ಕ ಅ ಩ ೇ ಕ	O
ಗಳು ಗಳು	ಗ ಳ ು ಗ ಳ ು	O
ರಜಪೂತ ರಜಪೂತ	ರ ಜ ಪ ೂ ತ ರ ಜ ಪ ೂ ತ	 LOC
	
	
, ,	, ,	O
. .	. .	O
ಜನ ಜನ	ಜ ನ ಜ ನ	 PER
	
ಸಂಭವಿಸುತ್ತಿದ್ದು ಸಂಭವಿಸುತ್ತಿದ್ದು	ಸ ಂ ಭ ವ ಿ ಸ ು ತ ್ ತ ಿ ದ ್ ದ ು ಸ ಂ ಭ ವ ಿ ಸ ು ತ ್ ತ ಿ ದ ್ ದ ು	O
. .	. .	O
ಹಾಗೂ ಹಾಗೂ	ಹ ಾ ಗ ೂ ಹ ಾ ಗ ೂ	O
ಸೋಲಿಸುವ ಸೋಲಿಸುವ	ಸ ೋ ಲ ಿ ಸ ು ವ ಸ ೋ ಲ ಿ ಸ ು ವ	O
. .	. .	O
ಸುಲ್ತಾನನ ಸುಲ್ತಾನನ	ಸ ು ಲ ್ ತ ಾ ನ ನ ಸ ು ಲ ್ ತ ಾ ನ ನ	 PER
ಬಂದಿರಬೇಕು ಬಂದಿರಬೇಕು	ಬ ಂ ದ ಿ ರ ಬ ೇ ಕ ು ಬ ಂ ದ ಿ ರ ಬ ೇ ಕ ು	O
	
ಸಹ ಸಹ	ಸ ಹ ಸ ಹ	O
ಸಂಪುರ್ಣವಾಗಿ ಸಂಪುರ್ಣವಾಗಿ	ಸ ಂ ಪ ು ರ ್ ಣ ವ ಾ ಗ ಿ ಸ ಂ ಪ ು ರ ್ ಣ ವ ಾ ಗ ಿ	O
ಬೀವರ್ ಬೀವರ್	ಬ ೀ ವ ರ ್ ಬ ೀ ವ ರ ್	B-PER
ಬಿಟ್ಟುಹೋದನು ಬಿಟ್ಟುಹೋದನು	ಬ ಿ ಟ ್ ಟ ು ಹ ೋ ದ ನ ು ಬ ಿ ಟ ್ ಟ ು ಹ ೋ ದ ನ ು	O
ತೊರೆಯದಂತೆ ತೊರೆಯದಂತೆ	ತ ೊ ರ ೆ ಯ ದ ಂ ತ ೆ ತ ೊ ರ ೆ ಯ ದ ಂ ತ ೆ	O
	
ಸೈನ್ಯವನ್ನು ಸೈನ್ಯವನ್ನು	ಸ ೈ ನ ್ ಯ ವ ನ ್ ನ ು ಸ ೈ ನ ್ ಯ ವ ನ ್ ನ ು	O
ಬಂ ಬಂ	ಬ ಂ ಬ ಂ	O
ಚಾಲುಕ್ಯರ ಚಾಲುಕ್ಯರ	ಚ ಾ ಲ ು ಕ ್ ಯ ರ ಚ ಾ ಲ ು ಕ ್ ಯ ರ	 PER
ಮಗನಾಗಿ ಮಗನಾಗಿ	ಮ ಗ ನ ಾ ಗ ಿ ಮ ಗ ನ ಾ ಗ ಿ	B-ROL
ಪತ್ನಿಯಾಗಿದ್ದರು ಪತ್ನಿಯಾಗಿದ್ದರು	ಪ ತ ್ ನ ಿ ಯ ಾ ಗ ಿ ದ ್ ದ ರ ು ಪ ತ ್ ನ ಿ ಯ ಾ ಗ ಿ ದ ್ ದ ರ ು	B-ROL
ಸಮರ್ಪಿತ ಸಮರ್ಪಿತ	ಸ ಮ ರ ್ ಪ ಿ ತ ಸ ಮ ರ ್ ಪ ಿ ತ	O
ಬೆಂಗಳೂರು ಬೆಂಗಳೂರು	ಬ ೆ ಂ ಗ ಳ ೂ ರ ು ಬ ೆ ಂ ಗ ಳ ೂ ರ ು	 LOC
ಚರಿತ್ರೆಯನ್ನು ಚರಿತ್ರೆಯನ್ನು	ಚ ರ ಿ ತ ್ ರ ೆ ಯ ನ ್ ನ ು ಚ ರ ಿ ತ ್ ರ ೆ ಯ ನ ್ ನ ು	O
ಪದ್ಧತಿಯಲ್ಲಿದ್ದ ಪದ್ಧತಿಯಲ್ಲಿದ್ದ	ಪ ದ ್ ಧ ತ ಿ ಯ ಲ ್ ಲ ಿ ದ ್ ದ ಪ ದ ್ ಧ ತ ಿ ಯ ಲ ್ ಲ ಿ ದ ್ ದ	O
	
ವಿವಿಧ ವಿವಿಧ	ವ ಿ ವ ಿ ಧ ವ ಿ ವ ಿ ಧ	O
. .	. .	O
354 354	3 5 4 3 5 4	TME
ಅವಧಿಯಲ್ಲಿ ಅವಧಿಯಲ್ಲಿ	ಅ ವ ಧ ಿ ಯ ಲ ್ ಲ ಿ ಅ ವ ಧ ಿ ಯ ಲ ್ ಲ ಿ	O
ಸಲುವಾಗಿ ಸಲುವಾಗಿ	ಸ ಲ ು ವ ಾ ಗ ಿ ಸ ಲ ು ವ ಾ ಗ ಿ	O
ಗುಪ್ತರ ಗುಪ್ತರ	ಗ ು ಪ ್ ತ ರ ಗ ು ಪ ್ ತ ರ	B-PER
ಪಾತ್ರ ಪಾತ್ರ	ಪ ಾ ತ ್ ರ ಪ ಾ ತ ್ ರ	O
. .	. .	O
ಕೊಡುವ ಕೊಡುವ	ಕ ೊ ಡ ು ವ ಕ ೊ ಡ ು ವ	O
೯ ೯	೯ ೯	TME
ವ್ಯಾಪಾರಗಳು ವ್ಯಾಪಾರಗಳು	ವ ್ ಯ ಾ ಪ ಾ ರ ಗ ಳ ು ವ ್ ಯ ಾ ಪ ಾ ರ ಗ ಳ ು	O
ರಾಯಣ್ಣನನ್ನು ರಾಯಣ್ಣನನ್ನು	ರ ಾ ಯ ಣ ್ ಣ ನ ನ ್ ನ ು ರ ಾ ಯ ಣ ್ ಣ ನ ನ ್ ನ ು	 PER
. .	. .	O
ಷಾ ಷಾ	ಷ ಾ ಷ ಾ	B-PER
ಪರಿಷತ್ತನ್ನು ಪರಿಷತ್ತನ್ನು	ಪ ರ ಿ ಷ ತ ್ ತ ನ ್ ನ ು ಪ ರ ಿ ಷ ತ ್ ತ ನ ್ ನ ು	O
ಇನ್ನೂ ಇನ್ನೂ	ಇ ನ ್ ನ ೂ ಇ ನ ್ ನ ೂ	O
. .	. .	O
ಹೆಣ್ಣುಮಕ್ಕಳ ಹೆಣ್ಣುಮಕ್ಕಳ	ಹ ೆ ಣ ್ ಣ ು ಮ ಕ ್ ಕ ಳ ಹ ೆ ಣ ್ ಣ ು ಮ ಕ ್ ಕ ಳ	B-ROL
ಹಾಗೂ ಹಾಗೂ	ಹ ಾ ಗ ೂ ಹ ಾ ಗ ೂ	O
. .	. .	O
ಹೂಡಿ ಹೂಡಿ	ಹ ೂ ಡ ಿ ಹ ೂ ಡ ಿ	O
ಪ್ರಮುಖ ಪ್ರಮುಖ	ಪ ್ ರ ಮ ು ಖ ಪ ್ ರ ಮ ು ಖ	O
ಮೂಲಗಳಲ್ಲಿ ಮೂಲಗಳಲ್ಲಿ	ಮ ೂ ಲ ಗ ಳ ಲ ್ ಲ ಿ ಮ ೂ ಲ ಗ ಳ ಲ ್ ಲ ಿ	O
, ,	, ,	O
	
ಸಿದ್ದಿಖೀಯ ಸಿದ್ದಿಖೀಯ	ಸ ಿ ದ ್ ದ ಿ ಖ ೀ ಯ ಸ ಿ ದ ್ ದ ಿ ಖ ೀ ಯ	 PER
ಆರಾಧಕರಾಗಿದ್ದರು ಆರಾಧಕರಾಗಿದ್ದರು	ಆ ರ ಾ ಧ ಕ ರ ಾ ಗ ಿ ದ ್ ದ ರ ು ಆ ರ ಾ ಧ ಕ ರ ಾ ಗ ಿ ದ ್ ದ ರ ು	O
ಬಗ್ಗೆ ಬಗ್ಗೆ	ಬ ಗ ್ ಗ ೆ ಬ ಗ ್ ಗ ೆ	O
ಅಶೋಕನ ಅಶೋಕನ	ಅ ಶ ೋ ಕ ನ ಅ ಶ ೋ ಕ ನ	B-PER
ಇವುಗಳಲ್ಲಿ ಇವುಗಳಲ್ಲಿ	ಇ ವ ು ಗ ಳ ಲ ್ ಲ ಿ ಇ ವ ು ಗ ಳ ಲ ್ ಲ ಿ	O
ಕಟ್ಟುನಿಟ್ಟಾಗಿ ಕಟ್ಟುನಿಟ್ಟಾಗಿ	ಕ ಟ ್ ಟ ು ನ ಿ ಟ ್ ಟ ಾ ಗ ಿ ಕ ಟ ್ ಟ ು ನ ಿ ಟ ್ ಟ ಾ ಗ ಿ	O
ಬರುತ್ತವೆ ಬರುತ್ತವೆ	ಬ ರ ು ತ ್ ತ ವ ೆ ಬ ರ ು ತ ್ ತ ವ ೆ	O
ರಾಜ್ಯಗಳ ರಾಜ್ಯಗಳ	ರ ಾ ಜ ್ ಯ ಗ ಳ ರ ಾ ಜ ್ ಯ ಗ ಳ	O
ಕೂಡಿಸಲು ಕೂಡಿಸಲು	ಕ ೂ ಡ ಿ ಸ ಲ ು ಕ ೂ ಡ ಿ ಸ ಲ ು	O
ರಾಯ್ ರಾಯ್	ರ ಾ ಯ ್ ರ ಾ ಯ ್	 PER
ದಾರಿಯಲ್ಲಿ ದಾರಿಯಲ್ಲಿ	ದ ಾ ರ ಿ ಯ ಲ ್ ಲ ಿ ದ ಾ ರ ಿ ಯ ಲ ್ ಲ ಿ	O
ಎಂದು ಎಂದು	ಎ ಂ ದ ು ಎ ಂ ದ ು	O
. .	. .	O
ಪಡೆದು ಪಡೆದು	ಪ ಡ ೆ ದ ು ಪ ಡ ೆ ದ ು	O
. .	. .	O
	
ಗಂಗರ ಗಂಗರ	ಗ ಂ ಗ ರ ಗ ಂ ಗ ರ	B-COM
ಮೇಲೆ ಮೇಲೆ	ಮ ೇ ಲ ೆ ಮ ೇ ಲ ೆ	O
ವಾಸ್ಕೊ ವಾಸ್ಕೊ	ವ ಾ ಸ ್ ಕ ೊ ವ ಾ ಸ ್ ಕ ೊ	B-PER
. .	. .	O
ನಾಡೆಂದು ನಾಡೆಂದು	ನ ಾ ಡ ೆ ಂ ದ ು ನ ಾ ಡ ೆ ಂ ದ ು	O
ವಂಶದ ವಂಶದ	ವ ಂ ಶ ದ ವ ಂ ಶ ದ	O
ಅದನ್ನು ಅದನ್ನು	ಅ ದ ನ ್ ನ ು ಅ ದ ನ ್ ನ ು	O
ದೆಹಲಿ ದೆಹಲಿ	ದ ೆ ಹ ಲ ಿ ದ ೆ ಹ ಲ ಿ	 LOC
ಹೇಮುವಿನ ಹೇಮುವಿನ	ಹ ೇ ಮ ು ವ ಿ ನ ಹ ೇ ಮ ು ವ ಿ ನ	B-PER
6 6	6 6	O
ಟ್ರಸ್ಟ್ ಟ್ರಸ್ಟ್	ಟ ್ ರ ಸ ್ ಟ ್ ಟ ್ ರ ಸ ್ ಟ ್	O
. .	. .	O
ವಿರೂಪಾಕ್ಷನ ವಿರೂಪಾಕ್ಷನ	ವ ಿ ರ ೂ ಪ ಾ ಕ ್ ಷ ನ ವ ಿ ರ ೂ ಪ ಾ ಕ ್ ಷ ನ	O
ರೋಮನ್ನರನ್ನು ರೋಮನ್ನರನ್ನು	ರ ೋ ಮ ನ ್ ನ ರ ನ ್ ನ ು ರ ೋ ಮ ನ ್ ನ ರ ನ ್ ನ ು	B-COM
. .	. .	O
ಪರಮೇಶ್ವರವರ್ಮನ್ನ್ನು ಪರಮೇಶ್ವರವರ್ಮನ್ನ್ನು	ಪ ರ ಮ ೇ ಶ ್ ವ ರ ವ ರ ್ ಮ ನ ್ ನ ್ ನ ು ಪ ರ ಮ ೇ ಶ ್ ವ ರ ವ ರ ್ ಮ ನ ್ ನ ್ ನ ು	B-PER
. .	. .	O
ಅಧಿಕಾರಿಗಳಿ೦ದ ಅಧಿಕಾರಿಗಳಿ೦ದ	ಅ ಧ ಿ ಕ ಾ ರ ಿ ಗ ಳ ಿ ೦ ದ ಅ ಧ ಿ ಕ ಾ ರ ಿ ಗ ಳ ಿ ೦ ದ	O
ಕೇಳಿದೊಡನೆಯೇ ಕೇಳಿದೊಡನೆಯೇ	ಕ ೇ ಳ ಿ ದ ೊ ಡ ನ ೆ ಯ ೇ ಕ ೇ ಳ ಿ ದ ೊ ಡ ನ ೆ ಯ ೇ	O
	
ಪುಣೆಯ ಪುಣೆಯ	ಪ ು ಣ ೆ ಯ ಪ ು ಣ ೆ ಯ	 LOC
ಕಾರ್ಯ ಕಾರ್ಯ	ಕ ಾ ರ ್ ಯ ಕ ಾ ರ ್ ಯ	O
ಮಂಡಿಸಿದ ಮಂಡಿಸಿದ	ಮ ಂ ಡ ಿ ಸ ಿ ದ ಮ ಂ ಡ ಿ ಸ ಿ ದ	O
ಸ್ವೀಕರಿಸಿ ಸ್ವೀಕರಿಸಿ	ಸ ್ ವ ೀ ಕ ರ ಿ ಸ ಿ ಸ ್ ವ ೀ ಕ ರ ಿ ಸ ಿ	O
. .	. .	O
	
ಸಿಂಗ್ ಸಿಂಗ್	ಸ ಿ ಂ ಗ ್ ಸ ಿ ಂ ಗ ್	 PER
ಹುಲಿ ಹುಲಿ	ಹ ು ಲ ಿ ಹ ು ಲ ಿ	O
. .	. .	O
ಅಮೋಘವರ್ಷ ಅಮೋಘವರ್ಷ	ಅ ಮ ೋ ಘ ವ ರ ್ ಷ ಅ ಮ ೋ ಘ ವ ರ ್ ಷ	B-PER
ಸೈನಿಕರು ಸೈನಿಕರು	ಸ ೈ ನ ಿ ಕ ರ ು ಸ ೈ ನ ಿ ಕ ರ ು	B-ROL
	
೨೧ ೨೧	೨ ೧ ೨ ೧	TME
ಕಥೆಯಿದೆ ಕಥೆಯಿದೆ	ಕ ಥ ೆ ಯ ಿ ದ ೆ ಕ ಥ ೆ ಯ ಿ ದ ೆ	O
. .	. .	O
ಅಧಿಕಾರದಲ್ಲಿದ್ದ ಅಧಿಕಾರದಲ್ಲಿದ್ದ	ಅ ಧ ಿ ಕ ಾ ರ ದ ಲ ್ ಲ ಿ ದ ್ ದ ಅ ಧ ಿ ಕ ಾ ರ ದ ಲ ್ ಲ ಿ ದ ್ ದ	O
ಕಾಂಗ್ರೆಸ್ ಕಾಂಗ್ರೆಸ್	ಕ ಾ ಂ ಗ ್ ರ ೆ ಸ ್ ಕ ಾ ಂ ಗ ್ ರ ೆ ಸ ್	ORG
ಏಳು ಏಳು	ಏ ಳ ು
ದಿ ದಿ	ದ ಿ ದ ಿ	O
ಸಿಕ್ಕಿಬೀಳುತ್ತಾರೆ ಸಿಕ್ಕಿಬೀಳುತ್ತಾರೆ	ಸ ಿ ಕ ್ ಕ ಿ ಬ ೀ ಳ ು ತ ್ ತ ಾ ರ ೆ ಸ ಿ ಕ ್ ಕ ಿ ಬ ೀ ಳ ು ತ ್ ತ ಾ ರ ೆ	O
ಅಂತಃಕಲಹದಲ್ಲಿ ಅಂತಃಕಲಹದಲ್ಲಿ	ಅ ಂ ತ ಃ ಕ ಲ ಹ ದ ಲ ್ ಲ ಿ ಅ ಂ ತ ಃ ಕ ಲ ಹ ದ ಲ ್ ಲ ಿ	O
ಸೈನ್ಯವನ್ನು ಸೈನ್ಯವನ್ನು	ಸ ೈ ನ ್ ಯ ವ ನ ್ ನ ು ಸ ೈ ನ ್ ಯ ವ ನ ್ ನ ು	B-ROL
. .	. .	O
	
ಪ್ರಮುಖನು ಪ್ರಮುಖನು	ಪ ್ ರ ಮ ು ಖ ನ ು ಪ ್ ರ ಮ ು ಖ ನ ು	O
ನೇತೃತ್ವ ನೇತೃತ್ವ	ನ ೇ ತ ೃ ತ ್ ವ ನ ೇ ತ ೃ ತ ್ ವ	O
ತನ್ನ ತನ್ನ	ತ ನ ್ ನ ತ ನ ್ ನ	O
ಓಡಿ ಓಡಿ	ಓ ಡ ಿ ಓ ಡ ಿ	O
ಮಿಲನವುಳ್ಳ ಮಿಲನವುಳ್ಳ	ಮ ಿ ಲ ನ ವ ು ಳ ್ ಳ ಮ ಿ ಲ ನ ವ ು ಳ ್ ಳ	O
ಆಕ್ರಮಣಗಳು1 ಆಕ್ರಮಣಗಳು1	ಆ ಕ ್ ರ ಮ ಣ ಗ ಳ ು 1 ಆ ಕ ್ ರ ಮ ಣ ಗ ಳ ು 1	O
ವ್ಯಕ್ತಿಯೊಬ್ಬ ವ್ಯಕ್ತಿಯೊಬ್ಬ	ವ ್ ಯ ಕ ್ ತ ಿ ಯ ೊ ಬ ್ ಬ ವ ್ ಯ ಕ ್ ತ ಿ ಯ ೊ ಬ ್ ಬ	O
	
ಸಾಮ್ರಾಜ್ಯವನ್ನು ಸಾಮ್ರಾಜ್ಯವನ್ನು	ಸ ಾ ಮ ್ ರ ಾ ಜ ್ ಯ ವ ನ ್ ನ ು ಸ ಾ ಮ ್ ರ ಾ ಜ ್ ಯ ವ ನ ್ ನ ು	ORG
ಇಲ್ಲಿಯ ಇಲ್ಲಿಯ	ಇ ಲ ್ ಲ ಿ ಯ ಇ ಲ ್ ಲ ಿ ಯ	O
ಶಿಲೆಯು ಶಿಲೆಯು	ಶ ಿ ಲ ೆ ಯ ು ಶ ಿ ಲ ೆ ಯ ು	O
ಆಗಿದ್ದು ಆಗಿದ್ದು	ಆ ಗ ಿ ದ ್ ದ ು ಆ ಗ ಿ ದ ್ ದ ು	O
ಪುರಾಣಗಳಿಂದ ಪುರಾಣಗಳಿಂದ	ಪ ು ರ ಾ ಣ ಗ ಳ ಿ ಂ ದ ಪ ು ರ ಾ ಣ ಗ ಳ ಿ ಂ ದ	O
ಅಸುನೀಗಿರಬೇಕೆಂದು ಅಸುನೀಗಿರಬೇಕೆಂದು	ಅ ಸ ು ನ ೀ ಗ ಿ ರ ಬ ೇ ಕ ೆ ಂ ದ ು ಅ ಸ ು ನ ೀ ಗ ಿ ರ ಬ ೇ ಕ ೆ ಂ ದ ು	O
ಆಗಮನಕ್ಕೆ ಆಗಮನಕ್ಕೆ	ಆ ಗ ಮ ನ ಕ ್ ಕ ೆ ಆ ಗ ಮ ನ ಕ ್ ಕ ೆ	O
ಪ್ರಾದೇಶಿಕ ಪ್ರಾದೇಶಿಕ	ಪ ್ ರ ಾ ದ ೇ ಶ ಿ ಕ ಪ ್ ರ ಾ ದ ೇ ಶ ಿ ಕ	O
ಮತ್ತು ಮತ್ತು	ಮ ತ ್ ತ ು ಮ ತ ್ ತ ು	O
ಆಸ್ಥಾನದಲ್ಲಿದ್ದ ಆಸ್ಥಾನದಲ್ಲಿದ್ದ	ಆ ಸ ್ ಥ ಾ ನ ದ ಲ ್ ಲ ಿ ದ ್ ದ ಆ ಸ ್ ಥ ಾ ನ ದ ಲ ್ ಲ ಿ ದ ್ ದ	O
ಗೇರುಸೊಪ್ಪೆಯ ಗೇರುಸೊಪ್ಪೆಯ	ಗ ೇ ರ ು ಸ ೊ ಪ ್ ಪ ೆ ಯ ಗ ೇ ರ ು ಸ ೊ ಪ ್ ಪ ೆ ಯ	 LOC
, ,	, ,	O
ನವಂಬರ್ ನವಂಬರ್	ನ ವ ಂ ಬ ರ ್ ನ ವ ಂ ಬ ರ ್	O
೩೧ ೩೧	೩ ೧ ೩ ೧	TME
ಗುಲಾಮನನ್ನಾಗಿ ಗುಲಾಮನನ್ನಾಗಿ	ಗ ು ಲ ಾ ಮ ನ ನ ್ ನ ಾ ಗ ಿ ಗ ು ಲ ಾ ಮ ನ ನ ್ ನ ಾ ಗ ಿ	O
. .	. .	O
ಬ್ರಿಟೀಷರ ಬ್ರಿಟೀಷರ	ಬ ್ ರ ಿ ಟ ೀ ಷ ರ ಬ ್ ರ ಿ ಟ ೀ ಷ ರ	B-COM
ಯಮುನ ಯಮುನ	ಯ ಮ ು ನ ಯ ಮ ು ನ	O
ಮತ್ತು ಮತ್ತು	ಮ ತ ್ ತ ು ಮ ತ ್ ತ ು	O
ಶಾಸನ ಶಾಸನ	ಶ ಾ ಸ ನ ಶ ಾ ಸ ನ	ORG
ಸಿದ್ಧಪಡಿಸುವಲ್ಲಿ ಸಿದ್ಧಪಡಿಸುವಲ್ಲಿ	ಸ ಿ ದ ್ ಧ ಪ ಡ ಿ ಸ ು ವ ಲ ್ ಲ ಿ ಸ ಿ ದ ್ ಧ ಪ ಡ ಿ ಸ ು ವ ಲ ್ ಲ ಿ	O
ಪ್ರಾಂತ ಪ್ರಾಂತ	ಪ ್ ರ ಾ ಂ ತ ಪ ್ ರ ಾ ಂ ತ	O
ಮರಳುವಿಕೆಯ ಮರಳುವಿಕೆಯ	ಮ ರ ಳ ು ವ ಿ ಕ ೆ ಯ ಮ ರ ಳ ು ವ ಿ ಕ ೆ ಯ	O
ಸಾಮರ್ಥ್ಯ ಸಾಮರ್ಥ್ಯ	ಸ ಾ ಮ ರ ್ ಥ ್ ಯ ಸ ಾ ಮ ರ ್ ಥ ್ ಯ	O
ಐದು ಐದು	ಐ ದ ು
ಅರಸಿ ಅರಸಿ	ಅ ರ ಸ ಿ ಅ ರ ಸ ಿ	O
ಸ್ವಚ್ಛತೆ ಸ್ವಚ್ಛತೆ	ಸ ್ ವ ಚ ್ ಛ ತ ೆ ಸ ್ ವ ಚ ್ ಛ ತ ೆ	O
ಇತಿಹಾಸವು ಇತಿಹಾಸವು	ಇ ತ ಿ ಹ ಾ ಸ ವ ು ಇ ತ ಿ ಹ ಾ ಸ ವ ು	O
ಆ ಆ	ಆ ಆ	O
	
ಕಾಲದಲ್ಲಿಯೂ ಕಾಲದಲ್ಲಿಯೂ	ಕ ಾ ಲ ದ ಲ ್ ಲ ಿ ಯ ೂ ಕ ಾ ಲ ದ ಲ ್ ಲ ಿ ಯ ೂ	O
ಆಗಿದ್ದವು ಆಗಿದ್ದವು	ಆ ಗ ಿ ದ ್ ದ ವ ು ಆ ಗ ಿ ದ ್ ದ ವ ು	O
, ,	, ,	O
ಭಾಗವು ಭಾಗವು	ಭ ಾ ಗ ವ ು ಭ ಾ ಗ ವ ು	O
ಜನ ಜನ	ಜ ನ ಜ ನ	O
ಮೂರು ಮೂರು	ಮ ೂ ರ ು
ಫೆಬ್ರವರಿ ಫೆಬ್ರವರಿ	ಫ ೆ ಬ ್ ರ ವ ರ ಿ ಫ ೆ ಬ ್ ರ ವ ರ ಿ	O
ಕವಿಯಾಗಿ ಕವಿಯಾಗಿ	ಕ ವ ಿ ಯ ಾ ಗ ಿ ಕ ವ ಿ ಯ ಾ ಗ ಿ	B-ROL
ವಿಕ್ರಮಾದಿತ್ಯನು ವಿಕ್ರಮಾದಿತ್ಯನು	ವ ಿ ಕ ್ ರ ಮ ಾ ದ ಿ ತ ್ ಯ ನ ು ವ ಿ ಕ ್ ರ ಮ ಾ ದ ಿ ತ ್ ಯ ನ ು	 PER
. .	. .	O
ಹಾಗೂ ಹಾಗೂ	ಹ ಾ ಗ ೂ ಹ ಾ ಗ ೂ	O
ಬೌದ್ಧ ಬೌದ್ಧ	ಬ ೌ ದ ್ ಧ ಬ ೌ ದ ್ ಧ	B-COM
ಅಂತಿಮವಾಗಿ ಅಂತಿಮವಾಗಿ	ಅ ಂ ತ ಿ ಮ ವ ಾ ಗ ಿ ಅ ಂ ತ ಿ ಮ ವ ಾ ಗ ಿ	O
ಚೀಣಾ ಚೀಣಾ	ಚ ೀ ಣ ಾ ಚ ೀ ಣ ಾ	 LOC
ದಾವಣಗೆರೆಯಲ್ಲಿ ದಾವಣಗೆರೆಯಲ್ಲಿ	ದ ಾ ವ ಣ ಗ ೆ ರ ೆ ಯ ಲ ್ ಲ ಿ ದ ಾ ವ ಣ ಗ ೆ ರ ೆ ಯ ಲ ್ ಲ ಿ	 LOC
ಇದು ಇದು	ಇ ದ ು ಇ ದ ು	O
ಹುಬ್ಬಳ್ಳಿ ಹುಬ್ಬಳ್ಳಿ	ಹ ು ಬ ್ ಬ ಳ ್ ಳ ಿ ಹ ು ಬ ್ ಬ ಳ ್ ಳ ಿ	 LOC
ರಾಜನಾದನು ರಾಜನಾದನು	ರ ಾ ಜ ನ ಾ ದ ನ ು ರ ಾ ಜ ನ ಾ ದ ನ ು	B-ROL
ನಿರ್ಧಾರವಾಗುತ್ತಿದ್ದಿತು ನಿರ್ಧಾರವಾಗುತ್ತಿದ್ದಿತು	ನ ಿ ರ ್ ಧ ಾ ರ ವ ಾ ಗ ು ತ ್ ತ ಿ ದ ್ ದ ಿ ತ ು ನ ಿ ರ ್ ಧ ಾ ರ ವ ಾ ಗ ು ತ ್ ತ ಿ ದ ್ ದ ಿ ತ ು	O
. .	. .	O
ಕ್ರೌರ್ಯವನ್ನು ಕ್ರೌರ್ಯವನ್ನು	ಕ ್ ರ ೌ ರ ್ ಯ ವ ನ ್ ನ ು ಕ ್ ರ ೌ ರ ್ ಯ ವ ನ ್ ನ ು	O
ಅರಸ ಅರಸ	ಅ ರ ಸ ಅ ರ ಸ	B-ROL
ಸದ್ಯದಲ್ಲಿಯೇ ಸದ್ಯದಲ್ಲಿಯೇ	ಸ ದ ್ ಯ ದ ಲ ್ ಲ ಿ ಯ ೇ ಸ ದ ್ ಯ ದ ಲ ್ ಲ ಿ ಯ ೇ	O
ಅನುಷ್ಠಾನಕ್ಕೆ ಅನುಷ್ಠಾನಕ್ಕೆ	ಅ ನ ು ಷ ್ ಠ ಾ ನ ಕ ್ ಕ ೆ ಅ ನ ು ಷ ್ ಠ ಾ ನ ಕ ್ ಕ ೆ	O
ಆಳ್ವಿಕೆಗೆ ಆಳ್ವಿಕೆಗೆ	ಆ ಳ ್ ವ ಿ ಕ ೆ ಗ ೆ ಆ ಳ ್ ವ ಿ ಕ ೆ ಗ ೆ	O
7 7	7 7	TME
ಒಡ್ಡಿಕೊಂಡಿದ್ದರೂ ಒಡ್ಡಿಕೊಂಡಿದ್ದರೂ	ಒ ಡ ್ ಡ ಿ ಕ ೊ ಂ ಡ ಿ ದ ್ ದ ರ ೂ ಒ ಡ ್ ಡ ಿ ಕ ೊ ಂ ಡ ಿ ದ ್ ದ ರ ೂ	O
ಸುಧಾರಣೆಯೊಂದಿಗೆ ಸುಧಾರಣೆಯೊಂದಿಗೆ	ಸ ು ಧ ಾ ರ ಣ ೆ ಯ ೊ ಂ ದ ಿ ಗ ೆ ಸ ು ಧ ಾ ರ ಣ ೆ ಯ ೊ ಂ ದ ಿ ಗ ೆ	O
ಬ್ರಿಟೀಷ್ ಬ್ರಿಟೀಷ್	ಬ ್ ರ ಿ ಟ ೀ ಷ ್ ಬ ್ ರ ಿ ಟ ೀ ಷ ್	B-COM
ಸ್ತ್ರಿಯರಿಗೂ ಸ್ತ್ರಿಯರಿಗೂ	ಸ ್ ತ ್ ರ ಿ ಯ ರ ಿ ಗ ೂ ಸ ್ ತ ್ ರ ಿ ಯ ರ ಿ ಗ ೂ	B-COM
ದೇಸಾಯರ ದೇಸಾಯರ	ದ ೇ ಸ ಾ ಯ ರ ದ ೇ ಸ ಾ ಯ ರ	 PER
ಕಟ್ಟಲಾಗುತ್ತಿತ್ತು ಕಟ್ಟಲಾಗುತ್ತಿತ್ತು	ಕ ಟ ್ ಟ ಲ ಾ ಗ ು ತ ್ ತ ಿ ತ ್ ತ ು ಕ ಟ ್ ಟ ಲ ಾ ಗ ು ತ ್ ತ ಿ ತ ್ ತ ು	O
ಕಾಲದಲ್ಲಿ ಕಾಲದಲ್ಲಿ	ಕ ಾ ಲ ದ ಲ ್ ಲ ಿ ಕ ಾ ಲ ದ ಲ ್ ಲ ಿ	O
ಕೆಂಪೇಗೌಡ ಕೆಂಪೇಗೌಡ	ಕ ೆ ಂ ಪ ೇ ಗ ೌ ಡ ಕ ೆ ಂ ಪ ೇ ಗ ೌ ಡ	B-PER
ಸಂಧಿವಿಗ್ರಹಿ ಸಂಧಿವಿಗ್ರಹಿ	ಸ ಂ ಧ ಿ ವ ಿ ಗ ್ ರ ಹ ಿ ಸ ಂ ಧ ಿ ವ ಿ ಗ ್ ರ ಹ ಿ	B-ROL
ಒಂದನೆಯ ಒಂದನೆಯ	ಒ ಂ ದ ನ ೆ ಯ
ಆತನ ಆತನ	ಆ ತ ನ ಆ ತ ನ	O
	
ಅವಧಿಯ ಅವಧಿಯ	ಅ ವ ಧ ಿ ಯ ಅ ವ ಧ ಿ ಯ	O
ಪ್ರವರ್ಧಮಾನಕ್ಕೆ ಪ್ರವರ್ಧಮಾನಕ್ಕೆ	ಪ ್ ರ ವ ರ ್ ಧ ಮ ಾ ನ ಕ ್ ಕ ೆ ಪ ್ ರ ವ ರ ್ ಧ ಮ ಾ ನ ಕ ್ ಕ ೆ	O
ಜಿಲ್ಲೆ ಜಿಲ್ಲೆ	ಜ ಿ ಲ ್ ಲ ೆ ಜ ಿ ಲ ್ ಲ ೆ	O
. .	. .	O
, ,	, ,	O
ಪ್ರಭಾವ ಪ್ರಭಾವ	ಪ ್ ರ ಭ ಾ ವ ಪ ್ ರ ಭ ಾ ವ	O
ಜನಪ್ರಿಯಗೊಳಿಸಿದರು ಜನಪ್ರಿಯಗೊಳಿಸಿದರು	ಜ ನ ಪ ್ ರ ಿ ಯ ಗ ೊ ಳ ಿ ಸ ಿ ದ ರ ು ಜ ನ ಪ ್ ರ ಿ ಯ ಗ ೊ ಳ ಿ ಸ ಿ ದ ರ ು	O
ಸಾಮ್ರಾಜ್ಯ ಸಾಮ್ರಾಜ್ಯ	ಸ ಾ ಮ ್ ರ ಾ ಜ ್ ಯ ಸ ಾ ಮ ್ ರ ಾ ಜ ್ ಯ	ORG
ಮೇಡಮ್ ಮೇಡಮ್	ಮ ೇ ಡ ಮ ್ ಮ ೇ ಡ ಮ ್	 LOC
ಭಾರತದಲ್ಲಿ ಭಾರತದಲ್ಲಿ	ಭ ಾ ರ ತ ದ ಲ ್ ಲ ಿ ಭ ಾ ರ ತ ದ ಲ ್ ಲ ಿ	 LOC
ಹಲವಾರು ಹಲವಾರು	ಹ ಲ ವ ಾ ರ ು ಹ ಲ ವ ಾ ರ ು	O
ಅದಿಕಾರವನ್ನು ಅದಿಕಾರವನ್ನು	ಅ ದ ಿ ಕ ಾ ರ ವ ನ ್ ನ ು ಅ ದ ಿ ಕ ಾ ರ ವ ನ ್ ನ ು	O
. .	. .	O
ಸೈನಿಕರಲ್ಲಿ ಸೈನಿಕರಲ್ಲಿ	ಸ ೈ ನ ಿ ಕ ರ ಲ ್ ಲ ಿ ಸ ೈ ನ ಿ ಕ ರ ಲ ್ ಲ ಿ	O
ಮಾಡಿದ್ದಾಗಿದೆ ಮಾಡಿದ್ದಾಗಿದೆ	ಮ ಾ ಡ ಿ ದ ್ ದ ಾ ಗ ಿ ದ ೆ ಮ ಾ ಡ ಿ ದ ್ ದ ಾ ಗ ಿ ದ ೆ	O
ದಿನದಿನಕ್ಕೆ ದಿನದಿನಕ್ಕೆ	ದ ಿ ನ ದ ಿ ನ ಕ ್ ಕ ೆ ದ ಿ ನ ದ ಿ ನ ಕ ್ ಕ ೆ	O
ಶ್ರೀವಲ್ಲಭ ಶ್ರೀವಲ್ಲಭ	ಶ ್ ರ ೀ ವ ಲ ್ ಲ ಭ ಶ ್ ರ ೀ ವ ಲ ್ ಲ ಭ	O
ಜನರಂತೆಯೇ ಜನರಂತೆಯೇ	ಜ ನ ರ ಂ ತ ೆ ಯ ೇ ಜ ನ ರ ಂ ತ ೆ ಯ ೇ	O
ಕಾಲಿಟ್ಟ ಕಾಲಿಟ್ಟ	ಕ ಾ ಲ ಿ ಟ ್ ಟ ಕ ಾ ಲ ಿ ಟ ್ ಟ	O
ಅಂಡ್ ಅಂಡ್	ಅ ಂ ಡ ್ ಅ ಂ ಡ ್	O
ದನಿ ದನಿ	ದ ನ ಿ ದ ನ ಿ	O
೨೦ ೨೦	೨ ೦
	
ರಾಶ್ಟ್ರಕೂಟರೊಂದಿಗೆ ರಾಶ್ಟ್ರಕೂಟರೊಂದಿಗೆ	ರ ಾ ಶ ್ ಟ ್ ರ ಕ ೂ ಟ ರ ೊ ಂ ದ ಿ ಗ ೆ ರ ಾ ಶ ್ ಟ ್ ರ ಕ ೂ ಟ ರ ೊ ಂ ದ ಿ ಗ ೆ	B-COM
ಪರಿಸ್ಥಿತಿಯಿದ್ದಿತು ಪರಿಸ್ಥಿತಿಯಿದ್ದಿತು	ಪ ರ ಿ ಸ ್ ಥ ಿ ತ ಿ ಯ ಿ ದ ್ ದ ಿ ತ ು ಪ ರ ಿ ಸ ್ ಥ ಿ ತ ಿ ಯ ಿ ದ ್ ದ ಿ ತ ು	O
	
ಮೇಲಿನ ಮೇಲಿನ	ಮ ೇ ಲ ಿ ನ ಮ ೇ ಲ ಿ ನ	O
	
ಭೌಗೋಳಿಕ ಭೌಗೋಳಿಕ	ಭ ೌ ಗ ೋ ಳ ಿ ಕ ಭ ೌ ಗ ೋ ಳ ಿ ಕ	O
ಯಾಚಿಸಿದಾಗ ಯಾಚಿಸಿದಾಗ	ಯ ಾ ಚ ಿ ಸ ಿ ದ ಾ ಗ ಯ ಾ ಚ ಿ ಸ ಿ ದ ಾ ಗ	O
ಸಹೋದರರೂ ಸಹೋದರರೂ	ಸ ಹ ೋ ದ ರ ರ ೂ ಸ ಹ ೋ ದ ರ ರ ೂ	B-ROL
ಅವನ ಅವನ	ಅ ವ ನ ಅ ವ ನ	O
ಖಂಡಿಸಿ ಖಂಡಿಸಿ	ಖ ಂ ಡ ಿ ಸ ಿ ಖ ಂ ಡ ಿ ಸ ಿ	O
ಹಂಪೆಯಲ್ಲಿ ಹಂಪೆಯಲ್ಲಿ	ಹ ಂ ಪ ೆ ಯ ಲ ್ ಲ ಿ ಹ ಂ ಪ ೆ ಯ ಲ ್ ಲ ಿ	 LOC
ಇತ್ತು ಇತ್ತು	ಇ ತ ್ ತ ು ಇ ತ ್ ತ ು	O
ಸೈನ್ಯಕ್ಕೆ ಸೈನ್ಯಕ್ಕೆ	ಸ ೈ ನ ್ ಯ ಕ ್ ಕ ೆ ಸ ೈ ನ ್ ಯ ಕ ್ ಕ ೆ	O
ಎಕರೆ ಎಕರೆ	ಎ ಕ ರ ೆ ಎ ಕ ರ ೆ	O
	
ಮತ್ತೊಮ್ಮೆ ಮತ್ತೊಮ್ಮೆ	ಮ ತ ್ ತ ೊ ಮ ್ ಮ ೆ ಮ ತ ್ ತ ೊ ಮ ್ ಮ ೆ	O
ಸೇರಿದಂತೆ ಸೇರಿದಂತೆ	ಸ ೇ ರ ಿ ದ ಂ ತ ೆ ಸ ೇ ರ ಿ ದ ಂ ತ ೆ	O
ಗಮನಾರ್ಹವಾದುದು ಗಮನಾರ್ಹವಾದುದು	ಗ ಮ ನ ಾ ರ ್ ಹ ವ ಾ ದ ು ದ ು ಗ ಮ ನ ಾ ರ ್ ಹ ವ ಾ ದ ು ದ ು	O
ಸಭೆಗಳನ್ನು ಸಭೆಗಳನ್ನು	ಸ ಭ ೆ ಗ ಳ ನ ್ ನ ು ಸ ಭ ೆ ಗ ಳ ನ ್ ನ ು	O
ಮತ್ತು ಮತ್ತು	ಮ ತ ್ ತ ು ಮ ತ ್ ತ ು	O
, ,	, ,	O
ಇಳಿ ಇಳಿ	ಇ ಳ ಿ ಇ ಳ ಿ	O
ತಿಮ್ಮಪ್ಪನ ತಿಮ್ಮಪ್ಪನ	ತ ಿ ಮ ್ ಮ ಪ ್ ಪ ನ ತ ಿ ಮ ್ ಮ ಪ ್ ಪ ನ	B-PER
. .	. .	O
ಇಲ್ಲಿ ಇಲ್ಲಿ	ಇ ಲ ್ ಲ ಿ ಇ ಲ ್ ಲ ಿ	O
ಕ್ರಿ ಕ್ರಿ	ಕ ್ ರ ಿ ಕ ್ ರ ಿ	O
ಬಗೆಗಿನ ಬಗೆಗಿನ	ಬ ಗ ೆ ಗ ಿ ನ ಬ ಗ ೆ ಗ ಿ ನ	O
ಬೆಂಗಳೂರಿನ ಬೆಂಗಳೂರಿನ	ಬ ೆ ಂ ಗ ಳ ೂ ರ ಿ ನ ಬ ೆ ಂ ಗ ಳ ೂ ರ ಿ ನ	B-LOC
ಕಾಂಪೌಂಡ್ ಕಾಂಪೌಂಡ್	ಕ ಾ ಂ ಪ ೌ ಂ ಡ ್ ಕ ಾ ಂ ಪ ೌ ಂ ಡ ್	O
	
ಸಮಿತಿಯನ್ನು ಸಮಿತಿಯನ್ನು	ಸ ಮ ಿ ತ ಿ ಯ ನ ್ ನ ು ಸ ಮ ಿ ತ ಿ ಯ ನ ್ ನ ು	O
ಸೇನೆಗೆ ಸೇನೆಗೆ	ಸ ೇ ನ ೆ ಗ ೆ ಸ ೇ ನ ೆ ಗ ೆ	O
ಅಜಾತಶತ್ರುವಿಗಿಂತ ಅಜಾತಶತ್ರುವಿಗಿಂತ	ಅ ಜ ಾ ತ ಶ ತ ್ ರ ು ವ ಿ ಗ ಿ ಂ ತ ಅ ಜ ಾ ತ ಶ ತ ್ ರ ು ವ ಿ ಗ ಿ ಂ ತ	O
ಪರಿಣಮಿಸಿತು ಪರಿಣಮಿಸಿತು	ಪ ರ ಿ ಣ ಮ ಿ ಸ ಿ ತ ು ಪ ರ ಿ ಣ ಮ ಿ ಸ ಿ ತ ು	O
ಉತ್ತರದ ಉತ್ತರದ	ಉ ತ ್ ತ ರ ದ ಉ ತ ್ ತ ರ ದ	 LOC
ಆಫ್ರಿಕಾದ ಆಫ್ರಿಕಾದ	ಆ ಫ ್ ರ ಿ ಕ ಾ ದ ಆ ಫ ್ ರ ಿ ಕ ಾ ದ	 LOC
ಗರ್ಭಿಣಿ ಗರ್ಭಿಣಿ	ಗ ರ ್ ಭ ಿ ಣ ಿ ಗ ರ ್ ಭ ಿ ಣ ಿ	O
ಪ್ರದೇಶಗಳು ಪ್ರದೇಶಗಳು	ಪ ್ ರ ದ ೇ ಶ ಗ ಳ ು ಪ ್ ರ ದ ೇ ಶ ಗ ಳ ು	O
ಬೇಡರ ಬೇಡರ	ಬ ೇ ಡ ರ ಬ ೇ ಡ ರ	B-COM
. .	. .	O
. .	. .	O
	
. .	. .	O
ದೇವಾಲಯದಿಂದ ದೇವಾಲಯದಿಂದ	ದ ೇ ವ ಾ ಲ ಯ ದ ಿ ಂ ದ ದ ೇ ವ ಾ ಲ ಯ ದ ಿ ಂ ದ	O
ಮಾನವ್ಯ ಮಾನವ್ಯ	ಮ ಾ ನ ವ ್ ಯ ಮ ಾ ನ ವ ್ ಯ	B-PER
ಮಂತ್ರಿಯಾಗಿಯೂ ಮಂತ್ರಿಯಾಗಿಯೂ	ಮ ಂ ತ ್ ರ ಿ ಯ ಾ ಗ ಿ ಯ ೂ ಮ ಂ ತ ್ ರ ಿ ಯ ಾ ಗ ಿ ಯ ೂ	O
ರಾಜರುಗಳ ರಾಜರುಗಳ	ರ ಾ ಜ ರ ು ಗ ಳ ರ ಾ ಜ ರ ು ಗ ಳ	B-ROL
ಹೊಂದಿಕೊಂಡ ಹೊಂದಿಕೊಂಡ	ಹ ೊ ಂ ದ ಿ ಕ ೊ ಂ ಡ ಹ ೊ ಂ ದ ಿ ಕ ೊ ಂ ಡ	O
ಏಕೆಂದರೆ ಏಕೆಂದರೆ	ಏ ಕ ೆ ಂ ದ ರ ೆ ಏ ಕ ೆ ಂ ದ ರ ೆ	O
	
ಜನ ಜನ	ಜ ನ ಜ ನ	O
ಪ್ರದೇಶಗಳು ಪ್ರದೇಶಗಳು	ಪ ್ ರ ದ ೇ ಶ ಗ ಳ ು ಪ ್ ರ ದ ೇ ಶ ಗ ಳ ು	O
	
ವೈಚಾರಿಕ ವೈಚಾರಿಕ	ವ ೈ ಚ ಾ ರ ಿ ಕ ವ ೈ ಚ ಾ ರ ಿ ಕ	O
ಖಾಸೀಂ ಖಾಸೀಂ	ಖ ಾ ಸ ೀ ಂ ಖ ಾ ಸ ೀ ಂ	 PER
ರಾಷ್ಟ್ರಗಳ ರಾಷ್ಟ್ರಗಳ	ರ ಾ ಷ ್ ಟ ್ ರ ಗ ಳ ರ ಾ ಷ ್ ಟ ್ ರ ಗ ಳ	O
೧೯೪೯ರಂದು ೧೯೪೯ರಂದು	೧ ೯ ೪ ೯ ರ ಂ ದ ು ೧ ೯ ೪ ೯ ರ ಂ ದ ು	TME
ಕಾರ್ಯ ಕಾರ್ಯ	ಕ ಾ ರ ್ ಯ ಕ ಾ ರ ್ ಯ	O
ಪುಷ್ಕರಣಿಗಳು ಪುಷ್ಕರಣಿಗಳು	ಪ ು ಷ ್ ಕ ರ ಣ ಿ ಗ ಳ ು ಪ ು ಷ ್ ಕ ರ ಣ ಿ ಗ ಳ ು	O
ಯೋಜನೆ ಯೋಜನೆ	ಯ ೋ ಜ ನ ೆ ಯ ೋ ಜ ನ ೆ	O
ಬಂದಿದೆ ಬಂದಿದೆ	ಬ ಂ ದ ಿ ದ ೆ ಬ ಂ ದ ಿ ದ ೆ	O
ಗೋವರ್ಧನ ಗೋವರ್ಧನ	ಗ ೋ ವ ರ ್ ಧ ನ ಗ ೋ ವ ರ ್ ಧ ನ	B-LOC
ಅವಳ ಅವಳ	ಅ ವ ಳ ಅ ವ ಳ	O
ಕೆರೆಗಳನ್ನು ಕೆರೆಗಳನ್ನು	ಕ ೆ ರ ೆ ಗ ಳ ನ ್ ನ ು ಕ ೆ ರ ೆ ಗ ಳ ನ ್ ನ ು	 LOC
ಯೆಂದು ಯೆಂದು	ಯ ೆ ಂ ದ ು ಯ ೆ ಂ ದ ು	O
ಎರಡು ಎರಡು	ಎ ರ ಡ ು ಎ ರ ಡ ು	O
ವಿಡಂಬನೆ ವಿಡಂಬನೆ	ವ ಿ ಡ ಂ ಬ ನ ೆ ವ ಿ ಡ ಂ ಬ ನ ೆ	O
. .	. .	O
ಶ ಶ	ಶ ಶ	O
. .	. .	O
. .	. .	O
ಮಧ್ಯಭಾಗದಲ್ಲಿ ಮಧ್ಯಭಾಗದಲ್ಲಿ	ಮ ಧ ್ ಯ ಭ ಾ ಗ ದ ಲ ್ ಲ ಿ ಮ ಧ ್ ಯ ಭ ಾ ಗ ದ ಲ ್ ಲ ಿ	O
, ,	, ,	O
ದ್ದರು ದ್ದರು	ದ ್ ದ ರ ು ದ ್ ದ ರ ು	O
ದಿಂದ ದಿಂದ	ದ ಿ ಂ ದ ದ ಿ ಂ ದ	O
. .	. .	O
ಮಾನವರ ಮಾನವರ	ಮ ಾ ನ ವ ರ ಮ ಾ ನ ವ ರ	O
ಸೀಮಿತ ಸೀಮಿತ	ಸ ೀ ಮ ಿ ತ ಸ ೀ ಮ ಿ ತ	O
ಗ್ರಾಮಾಡಳಿತದಲ್ಲಿ ಗ್ರಾಮಾಡಳಿತದಲ್ಲಿ	ಗ ್ ರ ಾ ಮ ಾ ಡ ಳ ಿ ತ ದ ಲ ್ ಲ ಿ ಗ ್ ರ ಾ ಮ ಾ ಡ ಳ ಿ ತ ದ ಲ ್ ಲ ಿ	O
ಊಳಿಗದವರಿಗೆ ಊಳಿಗದವರಿಗೆ	ಊ ಳ ಿ ಗ ದ ವ ರ ಿ ಗ ೆ ಊ ಳ ಿ ಗ ದ ವ ರ ಿ ಗ ೆ	B-COM
ವಾಸ್ತುಶಿಲ್ಪದಲ್ಲಿ ವಾಸ್ತುಶಿಲ್ಪದಲ್ಲಿ	ವ ಾ ಸ ್ ತ ು ಶ ಿ ಲ ್ ಪ ದ ಲ ್ ಲ ಿ ವ ಾ ಸ ್ ತ ು ಶ ಿ ಲ ್ ಪ ದ ಲ ್ ಲ ಿ	O
ಪೇಟೆ ಪೇಟೆ	ಪ ೇ ಟ ೆ ಪ ೇ ಟ ೆ	 LOC
ಮಲ್ಲಸರ್ಜ ಮಲ್ಲಸರ್ಜ	ಮ ಲ ್ ಲ ಸ ರ ್ ಜ ಮ ಲ ್ ಲ ಸ ರ ್ ಜ	 PER
ಸುತ್ತು ಸುತ್ತು	ಸ ು ತ ್ ತ ು ಸ ು ತ ್ ತ ು	O
ಜೈಪುರ್ಎಂದು ಜೈಪುರ್ಎಂದು	ಜ ೈ ಪ ು ರ ್ ಎ ಂ ದ ು ಜ ೈ ಪ ು ರ ್ ಎ ಂ ದ ು	B-LOC
ಝಾನ್ಸಿಯ ಝಾನ್ಸಿಯ	ಝ ಾ ನ ್ ಸ ಿ ಯ ಝ ಾ ನ ್ ಸ ಿ ಯ	 LOC
ಹಾಗು ಹಾಗು	ಹ ಾ ಗ ು ಹ ಾ ಗ ು	O
ಮಗಳಾದ ಮಗಳಾದ	ಮ ಗ ಳ ಾ ದ ಮ ಗ ಳ ಾ ದ	B-ROL
. .	. .	O
ಪೂ ಪೂ	ಪ ೂ ಪ ೂ	O
ಬೂದಿಯ ಬೂದಿಯ	ಬ ೂ ದ ಿ ಯ ಬ ೂ ದ ಿ ಯ	O
ಹಸ್ತಾಂತರಕ್ಕಾಗಿ ಹಸ್ತಾಂತರಕ್ಕಾಗಿ	ಹ ಸ ್ ತ ಾ ಂ ತ ರ ಕ ್ ಕ ಾ ಗ ಿ ಹ ಸ ್ ತ ಾ ಂ ತ ರ ಕ ್ ಕ ಾ ಗ ಿ	O
ಗುರುತಿಸುವುದು ಗುರುತಿಸುವುದು	ಗ ು ರ ು ತ ಿ ಸ ು ವ ು ದ ು ಗ ು ರ ು ತ ಿ ಸ ು ವ ು ದ ು	O
, ,	, ,	O
ಕೋಟೆಯನ್ನು ಕೋಟೆಯನ್ನು	ಕ ೋ ಟ ೆ ಯ ನ ್ ನ ು ಕ ೋ ಟ ೆ ಯ ನ ್ ನ ು	 LOC
ದಿನಚರಿಗಳು ದಿನಚರಿಗಳು	ದ ಿ ನ ಚ ರ ಿ ಗ ಳ ು ದ ಿ ನ ಚ ರ ಿ ಗ ಳ ು	O
. .	. .	O
, ,	, ,	O
ಧಣಿಗಳು ಧಣಿಗಳು	ಧ ಣ ಿ ಗ ಳ ು ಧ ಣ ಿ ಗ ಳ ು	B-COM
ಸಂದರ್ಭಗಳಲ್ಲಿ ಸಂದರ್ಭಗಳಲ್ಲಿ	ಸ ಂ ದ ರ ್ ಭ ಗ ಳ ಲ ್ ಲ ಿ ಸ ಂ ದ ರ ್ ಭ ಗ ಳ ಲ ್ ಲ ಿ	O
ಆಡಳಿತ ಆಡಳಿತ	ಆ ಡ ಳ ಿ ತ ಆ ಡ ಳ ಿ ತ	O
ರಾಜಧಾನಿಯ ರಾಜಧಾನಿಯ	ರ ಾ ಜ ಧ ಾ ನ ಿ ಯ ರ ಾ ಜ ಧ ಾ ನ ಿ ಯ	O
ರಸ್ತೆ ರಸ್ತೆ	ರ ಸ ್ ತ ೆ ರ ಸ ್ ತ ೆ	O
ನಗರವೇ ನಗರವೇ	ನ ಗ ರ ವ ೇ ನ ಗ ರ ವ ೇ	O
ಜಾಗೃತಿಗೆ ಜಾಗೃತಿಗೆ	ಜ ಾ ಗ ೃ ತ ಿ ಗ ೆ ಜ ಾ ಗ ೃ ತ ಿ ಗ ೆ	O
. .	. .	O
ಬಾಗದಲ್ಲಿ ಬಾಗದಲ್ಲಿ	ಬ ಾ ಗ ದ ಲ ್ ಲ ಿ ಬ ಾ ಗ ದ ಲ ್ ಲ ಿ	O
ಪ್ರಾಂಗಣದಲ್ಲಿ ಪ್ರಾಂಗಣದಲ್ಲಿ	ಪ ್ ರ ಾ ಂ ಗ ಣ ದ ಲ ್ ಲ ಿ ಪ ್ ರ ಾ ಂ ಗ ಣ ದ ಲ ್ ಲ ಿ	O
ಶಸ್ತ್ರ ಶಸ್ತ್ರ	ಶ ಸ ್ ತ ್ ರ ಶ ಸ ್ ತ ್ ರ	O
. .	. .	O
ಉಜ್ಬೆಕ್ ಉಜ್ಬೆಕ್	ಉ ಜ ್ ಬ ೆ ಕ ್ ಉ ಜ ್ ಬ ೆ ಕ ್	 LOC
೯೪೭ ೯೪೭	೯ ೪ ೭ ೯ ೪ ೭	TME
ಇವರು ಇವರು	ಇ ವ ರ ು ಇ ವ ರ ು	O
ಜಯ ಜಯ	ಜ ಯ ಜ ಯ	O
ಕೋಟೆ ಕೋಟೆ	ಕ ೋ ಟ ೆ ಕ ೋ ಟ ೆ	O
ಯುದ್ಧವೆಂದು ಯುದ್ಧವೆಂದು	ಯ ು ದ ್ ಧ ವ ೆ ಂ ದ ು ಯ ು ದ ್ ಧ ವ ೆ ಂ ದ ು	O
ಅರ್ಥಮಾಡಿಕೊಳ್ಳುವಿಕೆಯ ಅರ್ಥಮಾಡಿಕೊಳ್ಳುವಿಕೆಯ	ಅ ರ ್ ಥ ಮ ಾ ಡ ಿ ಕ ೊ ಳ ್ ಳ ು ವ ಿ ಕ ೆ ಯ ಅ ರ ್ ಥ ಮ ಾ ಡ ಿ ಕ ೊ ಳ ್ ಳ ು ವ ಿ ಕ ೆ ಯ	O
ರಾಜಧಾನಿನಗರವಾಗಿತ್ತು ರಾಜಧಾನಿನಗರವಾಗಿತ್ತು	ರ ಾ ಜ ಧ ಾ ನ ಿ ನ ಗ ರ ವ ಾ ಗ ಿ ತ ್ ತ ು ರ ಾ ಜ ಧ ಾ ನ ಿ ನ ಗ ರ ವ ಾ ಗ ಿ ತ ್ ತ ು	O
ಹೊಂದಿದ್ದ ಹೊಂದಿದ್ದ	ಹ ೊ ಂ ದ ಿ ದ ್ ದ ಹ ೊ ಂ ದ ಿ ದ ್ ದ	O
ಬ್ರಿಟಿಷ್ ಬ್ರಿಟಿಷ್	ಬ ್ ರ ಿ ಟ ಿ ಷ ್ ಬ ್ ರ ಿ ಟ ಿ ಷ ್	B-COM
ಅವಶ್ಯಕವಾದ ಅವಶ್ಯಕವಾದ	ಅ ವ ಶ ್ ಯ ಕ ವ ಾ ದ ಅ ವ ಶ ್ ಯ ಕ ವ ಾ ದ	O
ಉದ್ದ ಉದ್ದ	ಉ ದ ್ ದ ಉ ದ ್ ದ	O
ಬ್ರಿಟಿಷರಿಗೆ ಬ್ರಿಟಿಷರಿಗೆ	ಬ ್ ರ ಿ ಟ ಿ ಷ ರ ಿ ಗ ೆ ಬ ್ ರ ಿ ಟ ಿ ಷ ರ ಿ ಗ ೆ	B-COM
ದೇವಾಲಯವು ದೇವಾಲಯವು	ದ ೇ ವ ಾ ಲ ಯ ವ ು ದ ೇ ವ ಾ ಲ ಯ ವ ು	O
ಅರಿತಿದ್ದೇವೆ ಅರಿತಿದ್ದೇವೆ	ಅ ರ ಿ ತ ಿ ದ ್ ದ ೇ ವ ೆ ಅ ರ ಿ ತ ಿ ದ ್ ದ ೇ ವ ೆ	O
ಮರಣವನ್ನಪ್ಪಿದ ಮರಣವನ್ನಪ್ಪಿದ	ಮ ರ ಣ ವ ನ ್ ನ ಪ ್ ಪ ಿ ದ ಮ ರ ಣ ವ ನ ್ ನ ಪ ್ ಪ ಿ ದ	O
. .	. .	O
ವಸಾಹತುಶಾಹಿಗಳು ವಸಾಹತುಶಾಹಿಗಳು	ವ ಸ ಾ ಹ ತ ು ಶ ಾ ಹ ಿ ಗ ಳ ು ವ ಸ ಾ ಹ ತ ು ಶ ಾ ಹ ಿ ಗ ಳ ು	B-COM
	
, ,	, ,	O
ದುರ್ವಾಸ ದುರ್ವಾಸ	ದ ು ರ ್ ವ ಾ ಸ ದ ು ರ ್ ವ ಾ ಸ	B-PER
ಯಾವುದೇ ಯಾವುದೇ	ಯ ಾ ವ ು ದ ೇ ಯ ಾ ವ ು ದ ೇ	O
ಹೆಸರಾಯಿತೆಂದೂ ಹೆಸರಾಯಿತೆಂದೂ	ಹ ೆ ಸ ರ ಾ ಯ ಿ ತ ೆ ಂ ದ ೂ ಹ ೆ ಸ ರ ಾ ಯ ಿ ತ ೆ ಂ ದ ೂ	O
ಪಾವತಿ ಪಾವತಿ	ಪ ಾ ವ ತ ಿ ಪ ಾ ವ ತ ಿ	O
ಎ ಎ	ಎ ಎ	O
. .	. .	O
ಬಹುದೊಡ್ಡ ಬಹುದೊಡ್ಡ	ಬ ಹ ು ದ ೊ ಡ ್ ಡ ಬ ಹ ು ದ ೊ ಡ ್ ಡ	O
ಎಂದು ಎಂದು	ಎ ಂ ದ ು ಎ ಂ ದ ು	O
ರಾಣಿ ರಾಣಿ	ರ ಾ ಣ ಿ ರ ಾ ಣ ಿ	B-ROL
ಗೌರವಿಸುತ್ತಿದ್ದ ಗೌರವಿಸುತ್ತಿದ್ದ	ಗ ೌ ರ ವ ಿ ಸ ು ತ ್ ತ ಿ ದ ್ ದ ಗ ೌ ರ ವ ಿ ಸ ು ತ ್ ತ ಿ ದ ್ ದ	O
	
ಎಂಬ ಎಂಬ	ಎ ಂ ಬ ಎ ಂ ಬ	O
, ,	, ,	O
ವಿರೋಧಿಸಿತು ವಿರೋಧಿಸಿತು	ವ ಿ ರ ೋ ಧ ಿ ಸ ಿ ತ ು ವ ಿ ರ ೋ ಧ ಿ ಸ ಿ ತ ು	O
ಸರಾಸರಿ ಸರಾಸರಿ	ಸ ರ ಾ ಸ ರ ಿ ಸ ರ ಾ ಸ ರ ಿ	O
. .	. .	O
ಬೆಳಕು ಬೆಳಕು	ಬ ೆ ಳ ಕ ು ಬ ೆ ಳ ಕ ು	O
ಹೋಳ್ಕರ್ ಹೋಳ್ಕರ್	ಹ ೋ ಳ ್ ಕ ರ ್ ಹ ೋ ಳ ್ ಕ ರ ್	B-COM
ಜಗಜ್ಯೋತಿ ಜಗಜ್ಯೋತಿ	ಜ ಗ ಜ ್ ಯ ೊ ೕ ತ ಿ ಜ ಗ ಜ ್ ಯ ೊ ೕ ತ ಿ	 PER
ಅದರ ಅದರ	ಅ ದ ರ ಅ ದ ರ	O
ಸರ್ಜನ ಸರ್ಜನ	ಸ ರ ್ ಜ ನ ಸ ರ ್ ಜ ನ	 PER
ಲಕ್ಷ ಲಕ್ಷ	ಲ ಕ ್ ಷ
ಪಾತ್ರರಾದವರು ಪಾತ್ರರಾದವರು	ಪ ಾ ತ ್ ರ ರ ಾ ದ ವ ರ ು ಪ ಾ ತ ್ ರ ರ ಾ ದ ವ ರ ು	O
ಸೇವೆಗಳಾದ ಸೇವೆಗಳಾದ	ಸ ೇ ವ ೆ ಗ ಳ ಾ ದ ಸ ೇ ವ ೆ ಗ ಳ ಾ ದ	O
ಅವರ ಅವರ	ಅ ವ ರ ಅ ವ ರ	O
	
ಹೆಚ್ಚಿಸಿದರು ಹೆಚ್ಚಿಸಿದರು	ಹ ೆ ಚ ್ ಚ ಿ ಸ ಿ ದ ರ ು ಹ ೆ ಚ ್ ಚ ಿ ಸ ಿ ದ ರ ು	O
ಅಸಮರ್ಥನಾಗಿದ್ದರಿಂದ ಅಸಮರ್ಥನಾಗಿದ್ದರಿಂದ	ಅ ಸ ಮ ರ ್ ಥ ನ ಾ ಗ ಿ ದ ್ ದ ರ ಿ ಂ ದ ಅ ಸ ಮ ರ ್ ಥ ನ ಾ ಗ ಿ ದ ್ ದ ರ ಿ ಂ ದ	O
	
. .	. .	O
ಅಪರಿಗ್ರಹ ಅಪರಿಗ್ರಹ	ಅ ಪ ರ ಿ ಗ ್ ರ ಹ ಅ ಪ ರ ಿ ಗ ್ ರ ಹ	O
	
ಬಿನ್ನವಿಸಿದಳು ಬಿನ್ನವಿಸಿದಳು	ಬ ಿ ನ ್ ನ ವ ಿ ಸ ಿ ದ ಳ ು ಬ ಿ ನ ್ ನ ವ ಿ ಸ ಿ ದ ಳ ು	O
ರಾಜಧಾನಿಯಾಗಿ ರಾಜಧಾನಿಯಾಗಿ	ರ ಾ ಜ ಧ ಾ ನ ಿ ಯ ಾ ಗ ಿ ರ ಾ ಜ ಧ ಾ ನ ಿ ಯ ಾ ಗ ಿ	O
ರಣಥಂಭೋರ್ ರಣಥಂಭೋರ್	ರ ಣ ಥ ಂ ಭ ೋ ರ ್ ರ ಣ ಥ ಂ ಭ ೋ ರ ್	B-LOC
ಸಮಾರಂಭವನ್ನೇರ್ಪಡಿಸಿ ಸಮಾರಂಭವನ್ನೇರ್ಪಡಿಸಿ	ಸ ಮ ಾ ರ ಂ ಭ ವ ನ ್ ನ ೇ ರ ್ ಪ ಡ ಿ ಸ ಿ ಸ ಮ ಾ ರ ಂ ಭ ವ ನ ್ ನ ೇ ರ ್ ಪ ಡ ಿ ಸ ಿ	O
ಗಳಿಗೆ ಗಳಿಗೆ	ಗ ಳ ಿ ಗ ೆ ಗ ಳ ಿ ಗ ೆ	O
ನೀರಿನ ನೀರಿನ	ನ ೀ ರ ಿ ನ ನ ೀ ರ ಿ ನ	O
	
ಹಿಂದೂ ಹಿಂದೂ	ಹ ಿ ಂ ದ ೂ ಹ ಿ ಂ ದ ೂ	B-COM
ಅವರು ಅವರು	ಅ ವ ರ ು ಅ ವ ರ ು	O
ಅರ್ಥಶಾಸ್ತ್ರನಿಪುನರು ಅರ್ಥಶಾಸ್ತ್ರನಿಪುನರು	ಅ ರ ್ ಥ ಶ ಾ ಸ ್ ತ ್ ರ ನ ಿ ಪ ು ನ ರ ು ಅ ರ ್ ಥ ಶ ಾ ಸ ್ ತ ್ ರ ನ ಿ ಪ ು ನ ರ ು	O
500 500	5 0 0
ಹೇಳಿದೆ ಹೇಳಿದೆ	ಹ ೇ ಳ ಿ ದ ೆ ಹ ೇ ಳ ಿ ದ ೆ	O
ಮಗಳು ಮಗಳು	ಮ ಗ ಳ ು ಮ ಗ ಳ ು	O
, ,	, ,	O
ಈಗಾಗಲೇ ಈಗಾಗಲೇ	ಈ ಗ ಾ ಗ ಲ ೇ ಈ ಗ ಾ ಗ ಲ ೇ	O
ಮಂಡಿಸಿತು ಮಂಡಿಸಿತು	ಮ ಂ ಡ ಿ ಸ ಿ ತ ು ಮ ಂ ಡ ಿ ಸ ಿ ತ ು	O
ಭಾರತದಲ್ಲಿ ಭಾರತದಲ್ಲಿ	ಭ ಾ ರ ತ ದ ಲ ್ ಲ ಿ ಭ ಾ ರ ತ ದ ಲ ್ ಲ ಿ	B-LOC
ಭವಿಷ್ಯ ಭವಿಷ್ಯ	ಭ ವ ಿ ಷ ್ ಯ ಭ ವ ಿ ಷ ್ ಯ	O
ಶಾಕುಂತಲವು ಶಾಕುಂತಲವು	ಶ ಾ ಕ ು ಂ ತ ಲ ವ ು ಶ ಾ ಕ ು ಂ ತ ಲ ವ ು	O
ಪರಸ್ಪರ ಪರಸ್ಪರ	ಪ ರ ಸ ್ ಪ ರ ಪ ರ ಸ ್ ಪ ರ	O
ಅನುಯಾಯಿಗಳು ಅನುಯಾಯಿಗಳು	ಅ ನ ು ಯ ಾ ಯ ಿ ಗ ಳ ು ಅ ನ ು ಯ ಾ ಯ ಿ ಗ ಳ ು	O
	
ರಾಜಕೀಯ ರಾಜಕೀಯ	ರ ಾ ಜ ಕ ೀ ಯ ರ ಾ ಜ ಕ ೀ ಯ	O
ಕೊಡಗು ಕೊಡಗು	ಕ ೊ ಡ ಗ ು ಕ ೊ ಡ ಗ ು	 LOC
ಬ್ರಿಟಿಷರಿಗೂ ಬ್ರಿಟಿಷರಿಗೂ	ಬ ್ ರ ಿ ಟ ಿ ಷ ರ ಿ ಗ ೂ ಬ ್ ರ ಿ ಟ ಿ ಷ ರ ಿ ಗ ೂ	B-COM
	
ಈ ಈ	ಈ ಈ	O
ಚಂದ್ರಬೋಸರು ಚಂದ್ರಬೋಸರು	ಚ ಂ ದ ್ ರ ಬ ೋ ಸ ರ ು ಚ ಂ ದ ್ ರ ಬ ೋ ಸ ರ ು	 PER
ಕಂತುಗಳಲ್ಲಿ ಕಂತುಗಳಲ್ಲಿ	ಕ ಂ ತ ು ಗ ಳ ಲ ್ ಲ ಿ ಕ ಂ ತ ು ಗ ಳ ಲ ್ ಲ ಿ	O
೯೭೦ ೯೭೦	೯ ೭ ೦ ೯ ೭ ೦	TME
ಮರಣದಿಂದಾಗಿ ಮರಣದಿಂದಾಗಿ	ಮ ರ ಣ ದ ಿ ಂ ದ ಾ ಗ ಿ ಮ ರ ಣ ದ ಿ ಂ ದ ಾ ಗ ಿ	O
. .	. .	O
ಸಾಮ್ರಾಜ್ಯವನ್ನು ಸಾಮ್ರಾಜ್ಯವನ್ನು	ಸ ಾ ಮ ್ ರ ಾ ಜ ್ ಯ ವ ನ ್ ನ ು ಸ ಾ ಮ ್ ರ ಾ ಜ ್ ಯ ವ ನ ್ ನ ು	ORG
ಪ್ರಾಂತ ಪ್ರಾಂತ	ಪ ್ ರ ಾ ಂ ತ ಪ ್ ರ ಾ ಂ ತ	O
. .	. .	O
ಮಾಡಿದನು ಮಾಡಿದನು	ಮ ಾ ಡ ಿ ದ ನ ು ಮ ಾ ಡ ಿ ದ ನ ು	O
. .	. .	O
ಕ್ರಾಂತಿಕಾರಿಗಳಿಗೆ ಕ್ರಾಂತಿಕಾರಿಗಳಿಗೆ	ಕ ್ ರ ಾ ಂ ತ ಿ ಕ ಾ ರ ಿ ಗ ಳ ಿ ಗ ೆ ಕ ್ ರ ಾ ಂ ತ ಿ ಕ ಾ ರ ಿ ಗ ಳ ಿ ಗ ೆ	B-ROL
ಅದನ್ನು ಅದನ್ನು	ಅ ದ ನ ್ ನ ು ಅ ದ ನ ್ ನ ು	O
ಸ್ವಲ್ಪ ಸ್ವಲ್ಪ	ಸ ್ ವ ಲ ್ ಪ ಸ ್ ವ ಲ ್ ಪ	O
ಹೋಬಳಿಗಳ ಹೋಬಳಿಗಳ	ಹ ೋ ಬ ಳ ಿ ಗ ಳ ಹ ೋ ಬ ಳ ಿ ಗ ಳ	O
ಸೂರ್ಯನ ಸೂರ್ಯನ	ಸ ೂ ರ ್ ಯ ನ ಸ ೂ ರ ್ ಯ ನ	B-PER
, ,	, ,	O
	
ಮಹಿಳೆ ಮಹಿಳೆ	ಮ ಹ ಿ ಳ ೆ ಮ ಹ ಿ ಳ ೆ	B-ROL
	
ಹೆಡೆಯೆತ್ತುತ್ತವೆ ಹೆಡೆಯೆತ್ತುತ್ತವೆ	ಹ ೆ ಡ ೆ ಯ ೆ ತ ್ ತ ು ತ ್ ತ ವ ೆ ಹ ೆ ಡ ೆ ಯ ೆ ತ ್ ತ ು ತ ್ ತ ವ ೆ	O
	
ಚೀನ ಚೀನ	ಚ ೀ ನ ಚ ೀ ನ	B-LOC
	
ಮೆಚ್ಚಿಕೊಂಡವ ಮೆಚ್ಚಿಕೊಂಡವ	ಮ ೆ ಚ ್ ಚ ಿ ಕ ೊ ಂ ಡ ವ ಮ ೆ ಚ ್ ಚ ಿ ಕ ೊ ಂ ಡ ವ	O
ಥ್ಯಾಕರೆ ಥ್ಯಾಕರೆ	ಥ ್ ಯ ಾ ಕ ರ ೆ ಥ ್ ಯ ಾ ಕ ರ ೆ	 PER
. .	. .	O
ಇರಲಾರನೆಂದು ಇರಲಾರನೆಂದು	ಇ ರ ಲ ಾ ರ ನ ೆ ಂ ದ ು ಇ ರ ಲ ಾ ರ ನ ೆ ಂ ದ ು	O
ಬಂದ ಬಂದ	ಬ ಂ ದ ಬ ಂ ದ	O
ಕಳಿಸಲಾಯಿತು ಕಳಿಸಲಾಯಿತು	ಕ ಳ ಿ ಸ ಲ ಾ ಯ ಿ ತ ು ಕ ಳ ಿ ಸ ಲ ಾ ಯ ಿ ತ ು	O
ಮನವಿಗಳನ್ನು ಮನವಿಗಳನ್ನು	ಮ ನ ವ ಿ ಗ ಳ ನ ್ ನ ು ಮ ನ ವ ಿ ಗ ಳ ನ ್ ನ ು	O
ಸಂಸ್ಕೃತರೂಪ ಸಂಸ್ಕೃತರೂಪ	ಸ ಂ ಸ ್ ಕ ೃ ತ ರ ೂ ಪ ಸ ಂ ಸ ್ ಕ ೃ ತ ರ ೂ ಪ	O
ಗುಂಡಿನ ಗುಂಡಿನ	ಗ ು ಂ ಡ ಿ ನ ಗ ು ಂ ಡ ಿ ನ	O
. .	. .	O
ತತ್ವಗಳನ್ನು ತತ್ವಗಳನ್ನು	ತ ತ ್ ವ ಗ ಳ ನ ್ ನ ು ತ ತ ್ ವ ಗ ಳ ನ ್ ನ ು	O
ಕುರುಹುಗಳು ಕುರುಹುಗಳು	ಕ ು ರ ು ಹ ು ಗ ಳ ು ಕ ು ರ ು ಹ ು ಗ ಳ ು	O
ತಂದಿರುವುದು ತಂದಿರುವುದು	ತ ಂ ದ ಿ ರ ು ವ ು ದ ು ತ ಂ ದ ಿ ರ ು ವ ು ದ ು	O
ಶಿಶುನಾಗ ಶಿಶುನಾಗ	ಶ ಿ ಶ ು ನ ಾ ಗ ಶ ಿ ಶ ು ನ ಾ ಗ	B-PER
ತೆರಿಗೆಗಳು ತೆರಿಗೆಗಳು	ತ ೆ ರ ಿ ಗ ೆ ಗ ಳ ು ತ ೆ ರ ಿ ಗ ೆ ಗ ಳ ು	O
	
	
ಶಿಲ್ಪಕಲೆಗೆ ಶಿಲ್ಪಕಲೆಗೆ	ಶ ಿ ಲ ್ ಪ ಕ ಲ ೆ ಗ ೆ ಶ ಿ ಲ ್ ಪ ಕ ಲ ೆ ಗ ೆ	O
ಮಹಾರಾಣಿ ಮಹಾರಾಣಿ	ಮ ಹ ಾ ರ ಾ ಣ ಿ ಮ ಹ ಾ ರ ಾ ಣ ಿ	B-ROL
ನಡತೆಯಲ್ಲಿ ನಡತೆಯಲ್ಲಿ	ನ ಡ ತ ೆ ಯ ಲ ್ ಲ ಿ ನ ಡ ತ ೆ ಯ ಲ ್ ಲ ಿ	O
ಹೀಗಿವೆ ಹೀಗಿವೆ	ಹ ೀ ಗ ಿ ವ ೆ ಹ ೀ ಗ ಿ ವ ೆ	O
	
ತಡವಾಯಿತು ತಡವಾಯಿತು	ತ ಡ ವ ಾ ಯ ಿ ತ ು ತ ಡ ವ ಾ ಯ ಿ ತ ು	O
ಈ ಈ	ಈ ಈ	O
ನೀತಿಗಳನ್ನೇ ನೀತಿಗಳನ್ನೇ	ನ ೀ ತ ಿ ಗ ಳ ನ ್ ನ ೇ ನ ೀ ತ ಿ ಗ ಳ ನ ್ ನ ೇ	O
, ,	, ,	O
ಭೂಮಿಗಳನ್ನು ಭೂಮಿಗಳನ್ನು	ಭ ೂ ಮ ಿ ಗ ಳ ನ ್ ನ ು ಭ ೂ ಮ ಿ ಗ ಳ ನ ್ ನ ು	O
ಉಜ್ಜಯಿನಿ ಉಜ್ಜಯಿನಿ	ಉ ಜ ್ ಜ ಯ ಿ ನ ಿ ಉ ಜ ್ ಜ ಯ ಿ ನ ಿ	B-LOC
1411 1411	1 4 1 1
ಎಂಬಲ್ಲಿ ಎಂಬಲ್ಲಿ	ಎ ಂ ಬ ಲ ್ ಲ ಿ ಎ ಂ ಬ ಲ ್ ಲ ಿ	O
ಮಿಂಚನ್ನು ಮಿಂಚನ್ನು	ಮ ಿ ಂ ಚ ನ ್ ನ ು ಮ ಿ ಂ ಚ ನ ್ ನ ು	O
, ,	, ,	O
ಶಿವಲಿಂಗವೊಂದಿದೆ ಶಿವಲಿಂಗವೊಂದಿದೆ	ಶ ಿ ವ ಲ ಿ ಂ ಗ ವ ೊ ಂ ದ ಿ ದ ೆ ಶ ಿ ವ ಲ ಿ ಂ ಗ ವ ೊ ಂ ದ ಿ ದ ೆ	O
. .	. .	O
ಮಾಳಿಗೆಯನ್ನು ಮಾಳಿಗೆಯನ್ನು	ಮ ಾ ಳ ಿ ಗ ೆ ಯ ನ ್ ನ ು ಮ ಾ ಳ ಿ ಗ ೆ ಯ ನ ್ ನ ು	O
ಬಗೆಗೆ ಬಗೆಗೆ	ಬ ಗ ೆ ಗ ೆ ಬ ಗ ೆ ಗ ೆ	O
ಅಜ಼ಂ ಅಜ಼ಂ	ಅ ಜ ಼ ಂ ಅ ಜ ಼ ಂ	B-PER
ಯುಗವು ಯುಗವು	ಯ ು ಗ ವ ು ಯ ು ಗ ವ ು	O
ನ್ಯೂ ನ್ಯೂ	ನ ್ ಯ ೂ ನ ್ ಯ ೂ	 LOC
ಮುಘಲ್ ಮುಘಲ್	ಮ ು ಘ ಲ ್ ಮ ು ಘ ಲ ್	B-COM
ವೃತ್ತಾಕಾರದ ವೃತ್ತಾಕಾರದ	ವ ೃ ತ ್ ತ ಾ ಕ ಾ ರ ದ ವ ೃ ತ ್ ತ ಾ ಕ ಾ ರ ದ	O
. .	. .	O
, ,	, ,	O
	
	
ಇವನ ಇವನ	ಇ ವ ನ ಇ ವ ನ	O
, ,	, ,	O
ಅರ್ಥಶಾಸತ್ರಜ್ಞನೆಂದು ಅರ್ಥಶಾಸತ್ರಜ್ಞನೆಂದು	ಅ ರ ್ ಥ ಶ ಾ ಸ ತ ್ ರ ಜ ್ ಞ ನ ೆ ಂ ದ ು ಅ ರ ್ ಥ ಶ ಾ ಸ ತ ್ ರ ಜ ್ ಞ ನ ೆ ಂ ದ ು	O
ಹೊಂದಿದ್ದ ಹೊಂದಿದ್ದ	ಹ ೊ ಂ ದ ಿ ದ ್ ದ ಹ ೊ ಂ ದ ಿ ದ ್ ದ	O
ಮೇಲೆ ಮೇಲೆ	ಮ ೇ ಲ ೆ ಮ ೇ ಲ ೆ	O
	ಿ ಮತ್ತು ಅಝೀಮುಲ್ಲಾ (PER) ಖಾನ್; ಝಾನ್ಸಿ (LOC) ರಾಣಿ ಲಕ್ಷ್ಮೀ (PER) ಭಾಯಿ; ಕುಂವರ್ (PER) ಸಿಂಹ; ಬಿಹಾರ (LOC) ದ ಜಗದೀಶಪುರ (LOC) ದ ರಜಪೂತ (PER) ನಾಯಕ; ಮತ್ತು ಮುಘಲ್ (ORG) ದೊರೆ ಬಹಾದುರ್ ಶಹಾನ ಸಂಬಂಧಿ ಫಿರೂಝ್ (PER) ಶಹಾ.
ಗೊಳಿಸಬಹುದು ಗೊಳಿಸಬಹುದು	ಗ ೊ ಳ ಿ ಸ ಬ ಹ ು ದ ು ಗ ೊ ಳ ಿ ಸ ಬ ಹ ು ದ ು	O
. .	. .	O
	
ವೈವಿಧ್ಯಮಯವಾದ ವೈವಿಧ್ಯಮಯವಾದ	ವ ೈ ವ ಿ ಧ ್ ಯ ಮ ಯ ವ ಾ ದ ವ ೈ ವ ಿ ಧ ್ ಯ ಮ ಯ ವ ಾ ದ	O
ಕಳುಗಿಸುವ ಕಳುಗಿಸುವ	ಕ ಳ ು ಗ ಿ ಸ ು ವ ಕ ಳ ು ಗ ಿ ಸ ು ವ	O
ಹಣ ಹಣ	ಹ ಣ ಹ ಣ	O
ರಾಜಲಾಂಭನವಾಗಿತ್ತು ರಾಜಲಾಂಭನವಾಗಿತ್ತು	ರ ಾ ಜ ಲ ಾ ಂ ಭ ನ ವ ಾ ಗ ಿ ತ ್ ತ ು ರ ಾ ಜ ಲ ಾ ಂ ಭ ನ ವ ಾ ಗ ಿ ತ ್ ತ ು	O
ಮೊದಲಾದವರ ಮೊದಲಾದವರ	ಮ ೊ ದ ಲ ಾ ದ ವ ರ ಮ ೊ ದ ಲ ಾ ದ ವ ರ	O
ಪಾಟಲೀಪುತ್ರದಲ್ಲಿ ಪಾಟಲೀಪುತ್ರದಲ್ಲಿ	ಪ ಾ ಟ ಲ ೀ ಪ ು ತ ್ ರ ದ ಲ ್ ಲ ಿ ಪ ಾ ಟ ಲ ೀ ಪ ು ತ ್ ರ ದ ಲ ್ ಲ ಿ	B-LOC
. .	. .	O
ಅಲ್ಲಗೆಳೆಯುವ ಅಲ್ಲಗೆಳೆಯುವ	ಅ ಲ ್ ಲ ಗ ೆ ಳ ೆ ಯ ು ವ ಅ ಲ ್ ಲ ಗ ೆ ಳ ೆ ಯ ು ವ	O
. .	. .	O
. .	. .	O
ಬಹುಬೇಗೆ ಬಹುಬೇಗೆ	ಬ ಹ ು ಬ ೇ ಗ ೆ ಬ ಹ ು ಬ ೇ ಗ ೆ	O
ಸೌಹಾರ್ದತೆಯನ್ನು ಸೌಹಾರ್ದತೆಯನ್ನು	ಸ ೌ ಹ ಾ ರ ್ ದ ತ ೆ ಯ ನ ್ ನ ು ಸ ೌ ಹ ಾ ರ ್ ದ ತ ೆ ಯ ನ ್ ನ ು	O
ಪ್ರೌಢಶಾಲೆಯನ್ನು ಪ್ರೌಢಶಾಲೆಯನ್ನು	ಪ ್ ರ ೌ ಢ ಶ ಾ ಲ ೆ ಯ ನ ್ ನ ು ಪ ್ ರ ೌ ಢ ಶ ಾ ಲ ೆ ಯ ನ ್ ನ ು	ORG
ನಿಘಂಟನ್ನು ನಿಘಂಟನ್ನು	ನ ಿ ಘ ಂ ಟ ನ ್ ನ ು ನ ಿ ಘ ಂ ಟ ನ ್ ನ ು	O
ವೆಂಗಿ ವೆಂಗಿ	ವ ೆ ಂ ಗ ಿ ವ ೆ ಂ ಗ ಿ	B-PER
. .	. .	O
ಅನುಭವ ಅನುಭವ	ಅ ನ ು ಭ ವ ಅ ನ ು ಭ ವ	O
ಕೇಂಬ್ರಿಡ್ಜ್ ಕೇಂಬ್ರಿಡ್ಜ್	ಕ ೇ ಂ ಬ ್ ರ ಿ ಡ ್ ಜ ್ ಕ ೇ ಂ ಬ ್ ರ ಿ ಡ ್ ಜ ್	ORG
, ,	, ,	O
ಓಡಿಹೋದನು ಓಡಿಹೋದನು	ಓ ಡ ಿ ಹ ೋ ದ ನ ು ಓ ಡ ಿ ಹ ೋ ದ ನ ು	O
ಪದಪ್ರಯೋಗವಾಗಿದೆ ಪದಪ್ರಯೋಗವಾಗಿದೆ	ಪ ದ ಪ ್ ರ ಯ ೋ ಗ ವ ಾ ಗ ಿ ದ ೆ ಪ ದ ಪ ್ ರ ಯ ೋ ಗ ವ ಾ ಗ ಿ ದ ೆ	O
ಶಕ್ತಿ ಶಕ್ತಿ	ಶ ಕ ್ ತ ಿ ಶ ಕ ್ ತ ಿ	O
	
, ,	, ,	O
	
ಬ್ರಿಟಿಷರು ಬ್ರಿಟಿಷರು	ಬ ್ ರ ಿ ಟ ಿ ಷ ರ ು ಬ ್ ರ ಿ ಟ ಿ ಷ ರ ು	B-COM
ಲಾಭ ಲಾಭ	ಲ ಾ ಭ ಲ ಾ ಭ	O
ಬಳುವಳಿಯಾಗಿ ಬಳುವಳಿಯಾಗಿ	ಬ ಳ ು ವ ಳ ಿ ಯ ಾ ಗ ಿ ಬ ಳ ು ವ ಳ ಿ ಯ ಾ ಗ ಿ	O
ಬೈರಾಮ್ ಬೈರಾಮ್	ಬ ೈ ರ ಾ ಮ ್ ಬ ೈ ರ ಾ ಮ ್	B-PER
ರಚನೆ ರಚನೆ	ರ ಚ ನ ೆ ರ ಚ ನ ೆ	O
ಶತಮಾನಗಳವರೆಗೆ ಶತಮಾನಗಳವರೆಗೆ	ಶ ತ ಮ ಾ ನ ಗ ಳ ವ ರ ೆ ಗ ೆ ಶ ತ ಮ ಾ ನ ಗ ಳ ವ ರ ೆ ಗ ೆ	O
. .	. .	O
	
ಹಲಗಲಿಯಲ್ಲಿ ಹಲಗಲಿಯಲ್ಲಿ	ಹ ಲ ಗ ಲ ಿ ಯ ಲ ್ ಲ ಿ ಹ ಲ ಗ ಲ ಿ ಯ ಲ ್ ಲ ಿ	 LOC
೮ರಂದು ೮ರಂದು	೮ ರ ಂ ದ ು ೮ ರ ಂ ದ ು	TME
ಆದರೆ ಆದರೆ	ಆ ದ ರ ೆ ಆ ದ ರ ೆ	O
ಸಮಯದಲ್ಲಿ ಸಮಯದಲ್ಲಿ	ಸ ಮ ಯ ದ ಲ ್ ಲ ಿ ಸ ಮ ಯ ದ ಲ ್ ಲ ಿ	O
ಹೋಗಕೂಡದು ಹೋಗಕೂಡದು	ಹ ೋ ಗ ಕ ೂ ಡ ದ ು ಹ ೋ ಗ ಕ ೂ ಡ ದ ು	O
ಇಲ್ಲವಾದ್ದರಿಂದ ಇಲ್ಲವಾದ್ದರಿಂದ	ಇ ಲ ್ ಲ ವ ಾ ದ ್ ದ ರ ಿ ಂ ದ ಇ ಲ ್ ಲ ವ ಾ ದ ್ ದ ರ ಿ ಂ ದ	O
ಆದರೆ ಆದರೆ	ಆ ದ ರ ೆ ಆ ದ ರ ೆ	O
ಕಾಶ್ಮೀರ ಕಾಶ್ಮೀರ	ಕ ಾ ಶ ್ ಮ ೀ ರ ಕ ಾ ಶ ್ ಮ ೀ ರ	 LOC
. .	. .	O
ತನ್ನ ತನ್ನ	ತ ನ ್ ನ ತ ನ ್ ನ	O
ತಂದ ತಂದ	ತ ಂ ದ ತ ಂ ದ	O
ಪ್ರಮುಖ ಪ್ರಮುಖ	ಪ ್ ರ ಮ ು ಖ ಪ ್ ರ ಮ ು ಖ	O
ಸಾಮಾನ್ಯವಾಗಿ ಸಾಮಾನ್ಯವಾಗಿ	ಸ ಾ ಮ ಾ ನ ್ ಯ ವ ಾ ಗ ಿ ಸ ಾ ಮ ಾ ನ ್ ಯ ವ ಾ ಗ ಿ	O
320ರ 320ರ	3 2 0 ರ 3 2 0 ರ	TME
, ,	, ,	O
. .	. .	O
. .	. .	O
ಉದನ ಉದನ	ಉ ದ ನ ಉ ದ ನ	O
ಬೆಳೆಸಿದನು ಬೆಳೆಸಿದನು	ಬ ೆ ಳ ೆ ಸ ಿ ದ ನ ು ಬ ೆ ಳ ೆ ಸ ಿ ದ ನ ು	O
ಬಂದವು ಬಂದವು	ಬ ಂ ದ ವ ು ಬ ಂ ದ ವ ು	O
ಸಂಪುರ್ಣವಾಗಿ ಸಂಪುರ್ಣವಾಗಿ	ಸ ಂ ಪ ು ರ ್ ಣ ವ ಾ ಗ ಿ ಸ ಂ ಪ ು ರ ್ ಣ ವ ಾ ಗ ಿ	O
ಕಾರಣವಾಗಿ ಕಾರಣವಾಗಿ	ಕ ಾ ರ ಣ ವ ಾ ಗ ಿ ಕ ಾ ರ ಣ ವ ಾ ಗ ಿ	O
ಜನಸಂಖ್ಯೆ ಜನಸಂಖ್ಯೆ	ಜ ನ ಸ ಂ ಖ ್ ಯ ೆ ಜ ನ ಸ ಂ ಖ ್ ಯ ೆ	O
ನಾಯಕ ನಾಯಕ	ನ ಾ ಯ ಕ ನ ಾ ಯ ಕ	B-ROL
ತಮ್ಮ ತಮ್ಮ	ತ ಮ ್ ಮ ತ ಮ ್ ಮ	O
ಕೋಟೆ ಕೋಟೆ	ಕ ೋ ಟ ೆ ಕ ೋ ಟ ೆ	O
ಅಕಾಲ ಅಕಾಲ	ಅ ಕ ಾ ಲ ಅ ಕ ಾ ಲ	O
ರ ರ	ರ ರ	O
. .	. .	O
ಪೂ ಪೂ	ಪ ೂ ಪ ೂ	O
ಪರಿಗಣಿಸಿ ಪರಿಗಣಿಸಿ	ಪ ರ ಿ ಗ ಣ ಿ ಸ ಿ ಪ ರ ಿ ಗ ಣ ಿ ಸ ಿ	O
ಇರುವುದನ್ನು ಇರುವುದನ್ನು	ಇ ರ ು ವ ು ದ ನ ್ ನ ು ಇ ರ ು ವ ು ದ ನ ್ ನ ು	O
ರಾಜಧಾನಿಯನ್ನು ರಾಜಧಾನಿಯನ್ನು	ರ ಾ ಜ ಧ ಾ ನ ಿ ಯ ನ ್ ನ ು ರ ಾ ಜ ಧ ಾ ನ ಿ ಯ ನ ್ ನ ು	O
. .	. .	O
ಪತ್ರಿಕೆಗಳಿಗೆ ಪತ್ರಿಕೆಗಳಿಗೆ	ಪ ತ ್ ರ ಿ ಕ ೆ ಗ ಳ ಿ ಗ ೆ ಪ ತ ್ ರ ಿ ಕ ೆ ಗ ಳ ಿ ಗ ೆ	O
೪೬ ೪೬	೪ ೬
ಜನರಲ್ ಜನರಲ್	ಜ ನ ರ ಲ ್ ಜ ನ ರ ಲ ್	I-COM
೧೭೫೭ರಲ್ಲಿ ೧೭೫೭ರಲ್ಲಿ	೧ ೭ ೫ ೭ ರ ಲ ್ ಲ ಿ ೧ ೭ ೫ ೭ ರ ಲ ್ ಲ ಿ	TME
ಚುನಾವಣೆಯಲ್ಲಿ ಚುನಾವಣೆಯಲ್ಲಿ	ಚ ು ನ ಾ ವ ಣ ೆ ಯ ಲ ್ ಲ ಿ ಚ ು ನ ಾ ವ ಣ ೆ ಯ ಲ ್ ಲ ಿ	O
ಹೇಳಲಾಗಿದೆ ಹೇಳಲಾಗಿದೆ	ಹ ೇ ಳ ಲ ಾ ಗ ಿ ದ ೆ ಹ ೇ ಳ ಲ ಾ ಗ ಿ ದ ೆ	O
ಮರಾಠರ ಮರಾಠರ	ಮ ರ ಾ ಠ ರ ಮ ರ ಾ ಠ ರ	O
ಹಿಂದುಗಡೆ ಹಿಂದುಗಡೆ	ಹ ಿ ಂ ದ ು ಗ ಡ ೆ ಹ ಿ ಂ ದ ು ಗ ಡ ೆ	O
ಕ್ರಾಂತಿಕಾರಿಗಳಿಗೆ ಕ್ರಾಂತಿಕಾರಿಗಳಿಗೆ	ಕ ್ ರ ಾ ಂ ತ ಿ ಕ ಾ ರ ಿ ಗ ಳ ಿ ಗ ೆ ಕ ್ ರ ಾ ಂ ತ ಿ ಕ ಾ ರ ಿ ಗ ಳ ಿ ಗ ೆ	O
ಶೇರ್ ಶೇರ್	ಶ ೇ ರ ್ ಶ ೇ ರ ್	B-PER
ಪ್ರದೇಶಗಳನ್ನು ಪ್ರದೇಶಗಳನ್ನು	ಪ ್ ರ ದ ೇ ಶ ಗ ಳ ನ ್ ನ ು ಪ ್ ರ ದ ೇ ಶ ಗ ಳ ನ ್ ನ ು	O
	
	
ಬೇಡಿಕೊಂಡರು ಬೇಡಿಕೊಂಡರು	ಬ ೇ ಡ ಿ ಕ ೊ ಂ ಡ ರ ು ಬ ೇ ಡ ಿ ಕ ೊ ಂ ಡ ರ ು	O
ಬೌದ್ಧಧರ್ಮಕ್ಕೆ ಬೌದ್ಧಧರ್ಮಕ್ಕೆ	ಬ ೌ ದ ್ ಧ ಧ ರ ್ ಮ ಕ ್ ಕ ೆ ಬ ೌ ದ ್ ಧ ಧ ರ ್ ಮ ಕ ್ ಕ ೆ	O
. .	. .	O
ಮತ್ತು ಮತ್ತು	ಮ ತ ್ ತ ು ಮ ತ ್ ತ ು	O
ಆಳುವ ಆಳುವ	ಆ ಳ ು ವ ಆ ಳ ು ವ	O
ನೀತಿಯನ್ನು ನೀತಿಯನ್ನು	ನ ೀ ತ ಿ ಯ ನ ್ ನ ು ನ ೀ ತ ಿ ಯ ನ ್ ನ ು	O
	
ಸೈನಿಕ ಸೈನಿಕ	ಸ ೈ ನ ಿ ಕ ಸ ೈ ನ ಿ ಕ	B-ROL
. .	. .	O
ಎರಡನೆಯ ಎರಡನೆಯ	ಎ ರ ಡ ನ ೆ ಯ
೫೯ವರ್ಷಗಳ ೫೯ವರ್ಷಗಳ	೫ ೯ ವ ರ ್ ಷ ಗ ಳ ೫ ೯ ವ ರ ್ ಷ ಗ ಳ	TME
ರಾಷ್ಟ್ರ ರಾಷ್ಟ್ರ	ರ ಾ ಷ ್ ಟ ್ ರ ರ ಾ ಷ ್ ಟ ್ ರ	O
, ,	, ,	O
ಯೂರೋಪಿಯನ್ ಯೂರೋಪಿಯನ್	ಯ ೂ ರ ೋ ಪ ಿ ಯ ನ ್ ಯ ೂ ರ ೋ ಪ ಿ ಯ ನ ್	B-LOC
ಯುಗಗಳ ಯುಗಗಳ	ಯ ು ಗ ಗ ಳ ಯ ು ಗ ಗ ಳ	O
ದಾಳಿ ದಾಳಿ	ದ ಾ ಳ ಿ ದ ಾ ಳ ಿ	O
ಪ್ರಗತಿಗೆ ಪ್ರಗತಿಗೆ	ಪ ್ ರ ಗ ತ ಿ ಗ ೆ ಪ ್ ರ ಗ ತ ಿ ಗ ೆ	O
ಹಿಮ್ಮೆಟ್ಟಿಸಲು ಹಿಮ್ಮೆಟ್ಟಿಸಲು	ಹ ಿ ಮ ್ ಮ ೆ ಟ ್ ಟ ಿ ಸ ಲ ು ಹ ಿ ಮ ್ ಮ ೆ ಟ ್ ಟ ಿ ಸ ಲ ು	O
ಕಾರಣವಾಗಿತ್ತು ಕಾರಣವಾಗಿತ್ತು	ಕ ಾ ರ ಣ ವ ಾ ಗ ಿ ತ ್ ತ ು ಕ ಾ ರ ಣ ವ ಾ ಗ ಿ ತ ್ ತ ು	O
	
ಕಡಿಮೆ ಕಡಿಮೆ	ಕ ಡ ಿ ಮ ೆ ಕ ಡ ಿ ಮ ೆ	O
ನಾಲ್ಕನೇ ನಾಲ್ಕನೇ	ನ ಾ ಲ ್ ಕ ನ ೇ ನ ಾ ಲ ್ ಕ ನ ೇ	B-PER
ಹಳೆಯ ಹಳೆಯ	ಹ ಳ ೆ ಯ ಹ ಳ ೆ ಯ	O
ಮರಣದ ಮರಣದ	ಮ ರ ಣ ದ ಮ ರ ಣ ದ	O
1916ರಲ್ಲಿ 1916ರಲ್ಲಿ	1 9 1 6 ರ ಲ ್ ಲ ಿ
ಎತ್ತಿ ಎತ್ತಿ	ಎ ತ ್ ತ ಿ ಎ ತ ್ ತ ಿ	O
ಕೈಗಾರಿಕೆಗಳು ಕೈಗಾರಿಕೆಗಳು	ಕ ೈ ಗ ಾ ರ ಿ ಕ ೆ ಗ ಳ ು ಕ ೈ ಗ ಾ ರ ಿ ಕ ೆ ಗ ಳ ು	O
ಶತ್ರುವಿನ ಶತ್ರುವಿನ	ಶ ತ ್ ರ ು ವ ಿ ನ ಶ ತ ್ ರ ು ವ ಿ ನ	O
ತುಕ್ಕು ತುಕ್ಕು	ತ ು ಕ ್ ಕ ು ತ ು ಕ ್ ಕ ು	O
ಷೂಜಾ ಷೂಜಾ	ಷ ೂ ಜ ಾ ಷ ೂ ಜ ಾ	B-PER
ಕೈವಶ ಕೈವಶ	ಕ ೈ ವ ಶ ಕ ೈ ವ ಶ	O
ಅಥವಾ ಅಥವಾ	ಅ ಥ ವ ಾ ಅ ಥ ವ ಾ	O
ಸತ್ಯವನ್ನು ಸತ್ಯವನ್ನು	ಸ ತ ್ ಯ ವ ನ ್ ನ ು ಸ ತ ್ ಯ ವ ನ ್ ನ ು	O
ವಿಜಯಬಾಹುವಿನೊಂದಿಗೆ ವಿಜಯಬಾಹುವಿನೊಂದಿಗೆ	ವ ಿ ಜ ಯ ಬ ಾ ಹ ು ವ ಿ ನ ೊ ಂ ದ ಿ ಗ ೆ ವ ಿ ಜ ಯ ಬ ಾ ಹ ು ವ ಿ ನ ೊ ಂ ದ ಿ ಗ ೆ	B-PER
ಸಂತತಿಯ ಸಂತತಿಯ	ಸ ಂ ತ ತ ಿ ಯ ಸ ಂ ತ ತ ಿ ಯ	O
ರದ್ದುಗೊಳಿಸಿ ರದ್ದುಗೊಳಿಸಿ	ರ ದ ್ ದ ು ಗ ೊ ಳ ಿ ಸ ಿ ರ ದ ್ ದ ು ಗ ೊ ಳ ಿ ಸ ಿ	O
	
ಉಪ್ಪಿನ ಉಪ್ಪಿನ	ಉ ಪ ್ ಪ ಿ ನ ಉ ಪ ್ ಪ ಿ ನ	O
ಮಾಡಿ ಮಾಡಿ	ಮ ಾ ಡ ಿ ಮ ಾ ಡ ಿ	O
ಹಿಂದಿರುಗುವಂತೆ ಹಿಂದಿರುಗುವಂತೆ	ಹ ಿ ಂ ದ ಿ ರ ು ಗ ು ವ ಂ ತ ೆ ಹ ಿ ಂ ದ ಿ ರ ು ಗ ು ವ ಂ ತ ೆ	O
ಎಕರೆ ಎಕರೆ	ಎ ಕ ರ ೆ ಎ ಕ ರ ೆ	O
ಗೆಲುವಿಗೆ ಗೆಲುವಿಗೆ	ಗ ೆ ಲ ು ವ ಿ ಗ ೆ ಗ ೆ ಲ ು ವ ಿ ಗ ೆ	O
, ,	, ,	O
17ನೆಯ 17ನೆಯ	1 7 ನ ೆ ಯ
ಯೌವನಮದ ಯೌವನಮದ	ಯ ೌ ವ ನ ಮ ದ ಯ ೌ ವ ನ ಮ ದ	O
ಹೆಚ್ಚಿಸಿದ ಹೆಚ್ಚಿಸಿದ	ಹ ೆ ಚ ್ ಚ ಿ ಸ ಿ ದ ಹ ೆ ಚ ್ ಚ ಿ ಸ ಿ ದ	O
	
ತೊಡಿಸಿದರು ತೊಡಿಸಿದರು	ತ ೊ ಡ ಿ ಸ ಿ ದ ರ ು ತ ೊ ಡ ಿ ಸ ಿ ದ ರ ು	O
ಕೆಲಸ ಕೆಲಸ	ಕ ೆ ಲ ಸ ಕ ೆ ಲ ಸ	O
ಮಗಳಿಗೆ ಮಗಳಿಗೆ	ಮ ಗ ಳ ಿ ಗ ೆ ಮ ಗ ಳ ಿ ಗ ೆ	O
, ,	, ,	O
ಇವರು ಇವರು	ಇ ವ ರ ು ಇ ವ ರ ು	O
ಬರೆದುಕೊಂಡಿದ್ದಾನೆ ಬರೆದುಕೊಂಡಿದ್ದಾನೆ	ಬ ರ ೆ ದ ು ಕ ೊ ಂ ಡ ಿ ದ ್ ದ ಾ ನ ೆ ಬ ರ ೆ ದ ು ಕ ೊ ಂ ಡ ಿ ದ ್ ದ ಾ ನ ೆ	O
ಪಾಲ್ವಂಕರ್ ಪಾಲ್ವಂಕರ್	ಪ ಾ ಲ ್ ವ ಂ ಕ ರ ್ ಪ ಾ ಲ ್ ವ ಂ ಕ ರ ್	B-PER
ದೆಹಲಿ ದೆಹಲಿ	ದ ೆ ಹ ಲ ಿ ದ ೆ ಹ ಲ ಿ	 LOC
ಭೇಟಿಯ ಭೇಟಿಯ	ಭ ೇ ಟ ಿ ಯ ಭ ೇ ಟ ಿ ಯ	O
ಕಾನೂನು ಕಾನೂನು	ಕ ಾ ನ ೂ ನ ು ಕ ಾ ನ ೂ ನ ು	O
ಒಂದು ಒಂದು	ಒ ಂ ದ ು
. .	. .	O
ಶಾಂತಿ ಶಾಂತಿ	ಶ ಾ ಂ ತ ಿ ಶ ಾ ಂ ತ ಿ	O
ಇನ್ಫ್ಯಾಂಟ್ರಿ ಇನ್ಫ್ಯಾಂಟ್ರಿ	ಇ ನ ್ ಫ ್ ಯ ಾ ಂ ಟ ್ ರ ಿ ಇ ನ ್ ಫ ್ ಯ ಾ ಂ ಟ ್ ರ ಿ	O
ತಾಜುದ್ದೀನ್ ತಾಜುದ್ದೀನ್	ತ ಾ ಜ ು ದ ್ ದ ಿ ೕ ನ ್ ತ ಾ ಜ ು ದ ್ ದ ಿ ೕ ನ ್	B-PER
ಕಂದಾಯ ಕಂದಾಯ	ಕ ಂ ದ ಾ ಯ ಕ ಂ ದ ಾ ಯ	O
ಮಠಗಳು ಮಠಗಳು	ಮ ಠ ಗ ಳ ು ಮ ಠ ಗ ಳ ು	O
. .	. .	O
ಎಂಬುದನ್ನು ಎಂಬುದನ್ನು	ಎ ಂ ಬ ು ದ ನ ್ ನ ು ಎ ಂ ಬ ು ದ ನ ್ ನ ು	O
ಸೈನ್ಯವನ್ನು ಸೈನ್ಯವನ್ನು	ಸ ೈ ನ ್ ಯ ವ ನ ್ ನ ು ಸ ೈ ನ ್ ಯ ವ ನ ್ ನ ು	O
, ,	, ,	O
ಮಣ್ಣು ಮಣ್ಣು	ಮ ಣ ್ ಣ ು ಮ ಣ ್ ಣ ು	O
ಜಯಭೇರಿ ಜಯಭೇರಿ	ಜ ಯ ಭ ೇ ರ ಿ ಜ ಯ ಭ ೇ ರ ಿ	O
ವಿಚಾರ ವಿಚಾರ	ವ ಿ ಚ ಾ ರ ವ ಿ ಚ ಾ ರ	O
7ನೇ 7ನೇ	7 ನ ೇ 7 ನ ೇ	TME
ಫಿರಂಗಿಯಿಂದ ಫಿರಂಗಿಯಿಂದ	ಫ ಿ ರ ಂ ಗ ಿ ಯ ಿ ಂ ದ ಫ ಿ ರ ಂ ಗ ಿ ಯ ಿ ಂ ದ	O
೩ ೩	೩ ೩	TME
ಇದು ಇದು	ಇ ದ ು ಇ ದ ು	O
ರಂದು ರಂದು	ರ ಂ ದ ು ರ ಂ ದ ು	O
ಮಾರ್ಚ್ ಮಾರ್ಚ್	ಮ ಾ ರ ್ ಚ ್ ಮ ಾ ರ ್ ಚ ್	TME
ಇಲ್ಲಿನ ಇಲ್ಲಿನ	ಇ ಲ ್ ಲ ಿ ನ ಇ ಲ ್ ಲ ಿ ನ	O
ಈ ಈ	ಈ ಈ	O
ಪ್ರಯತ್ನ ಪ್ರಯತ್ನ	ಪ ್ ರ ಯ ತ ್ ನ ಪ ್ ರ ಯ ತ ್ ನ	O
ಹೊರಗೆ ಹೊರಗೆ	ಹ ೊ ರ ಗ ೆ ಹ ೊ ರ ಗ ೆ	O
ಮೇಲುಗೈ ಮೇಲುಗೈ	ಮ ೇ ಲ ು ಗ ೈ ಮ ೇ ಲ ು ಗ ೈ	O
ಮೂರನೆಯ ಮೂರನೆಯ	ಮ ೂ ರ ನ ೆ ಯ
ದೊರೆಯಾಗಿದ್ದನು ದೊರೆಯಾಗಿದ್ದನು	ದ ೊ ರ ೆ ಯ ಾ ಗ ಿ ದ ್ ದ ನ ು ದ ೊ ರ ೆ ಯ ಾ ಗ ಿ ದ ್ ದ ನ ು	O
	
ನಮಗೆ ನಮಗೆ	ನ ಮ ಗ ೆ ನ ಮ ಗ ೆ	O
, ,	, ,	O
ಮಾರ್ಪಟ್ಟ ಮಾರ್ಪಟ್ಟ	ಮ ಾ ರ ್ ಪ ಟ ್ ಟ ಮ ಾ ರ ್ ಪ ಟ ್ ಟ	O
ಉದ್ಯಾನದಲ್ಲಿದ್ದ ಉದ್ಯಾನದಲ್ಲಿದ್ದ	ಉ ದ ್ ಯ ಾ ನ ದ ಲ ್ ಲ ಿ ದ ್ ದ ಉ ದ ್ ಯ ಾ ನ ದ ಲ ್ ಲ ಿ ದ ್ ದ	O
ಪ್ರಾಚೀನ ಪ್ರಾಚೀನ	ಪ ್ ರ ಾ ಚ ೀ ನ ಪ ್ ರ ಾ ಚ ೀ ನ	O
ಎಲ್ಲ ಎಲ್ಲ	ಎ ಲ ್ ಲ ಎ ಲ ್ ಲ	O
ಧಾಳಿ ಧಾಳಿ	ಧ ಾ ಳ ಿ ಧ ಾ ಳ ಿ	O
	
ಹಾಗೂ ಹಾಗೂ	ಹ ಾ ಗ ೂ ಹ ಾ ಗ ೂ	O
	
ಶಾಸನವು ಶಾಸನವು	ಶ ಾ ಸ ನ ವ ು ಶ ಾ ಸ ನ ವ ು	O
ಆಗ ಆಗ	ಆ ಗ ಆ ಗ	O
ಕಿತ್ತೂರಿನ ಕಿತ್ತೂರಿನ	ಕ ಿ ತ ್ ತ ೂ ರ ಿ ನ ಕ ಿ ತ ್ ತ ೂ ರ ಿ ನ	B-LOC
	
ಜ್ವಾಲಾಮಾಲಿನಿ ಜ್ವಾಲಾಮಾಲಿನಿ	ಜ ್ ವ ಾ ಲ ಾ ಮ ಾ ಲ ಿ ನ ಿ ಜ ್ ವ ಾ ಲ ಾ ಮ ಾ ಲ ಿ ನ ಿ	 LOC
ನಿರ್ಣಯದ ನಿರ್ಣಯದ	ನ ಿ ರ ್ ಣ ಯ ದ ನ ಿ ರ ್ ಣ ಯ ದ	O
ಬೂದಿಮಾಡಿದರಾದರೂ ಬೂದಿಮಾಡಿದರಾದರೂ	ಬ ೂ ದ ಿ ಮ ಾ ಡ ಿ ದ ರ ಾ ದ ರ ೂ ಬ ೂ ದ ಿ ಮ ಾ ಡ ಿ ದ ರ ಾ ದ ರ ೂ	O
ವ್ಯಕ್ತಿ ವ್ಯಕ್ತಿ	ವ ್ ಯ ಕ ್ ತ ಿ ವ ್ ಯ ಕ ್ ತ ಿ	O
ಮುಂದೆ ಮುಂದೆ	ಮ ು ಂ ದ ೆ ಮ ು ಂ ದ ೆ	O
ಅಸಹಕಾರ ಅಸಹಕಾರ	ಅ ಸ ಹ ಕ ಾ ರ ಅ ಸ ಹ ಕ ಾ ರ	O
. .	. .	O
ವರ್ಷಗಳ ವರ್ಷಗಳ	ವ ರ ್ ಷ ಗ ಳ ವ ರ ್ ಷ ಗ ಳ	O
ಒಳಸುಂಕವನ್ನು ಒಳಸುಂಕವನ್ನು	ಒ ಳ ಸ ು ಂ ಕ ವ ನ ್ ನ ು ಒ ಳ ಸ ು ಂ ಕ ವ ನ ್ ನ ು	O
ಶ ಶ	ಶ ಶ	O
, ,	, ,	O
	
. .	. .	O
ಸಿಂಧೂ ಸಿಂಧೂ	ಸ ಿ ಂ ಧ ೂ ಸ ಿ ಂ ಧ ೂ	O
	
ಶಕ್ತನಾಗಿರುವುದು ಶಕ್ತನಾಗಿರುವುದು	ಶ ಕ ್ ತ ನ ಾ ಗ ಿ ರ ು ವ ು ದ ು ಶ ಕ ್ ತ ನ ಾ ಗ ಿ ರ ು ವ ು ದ ು	O
ಯುದ್ಧದಲ್ಲಿ ಯುದ್ಧದಲ್ಲಿ	ಯ ು ದ ್ ಧ ದ ಲ ್ ಲ ಿ ಯ ು ದ ್ ಧ ದ ಲ ್ ಲ ಿ	O
ದೇವನುಕೃಷ್ಣದೇವರಾಯನನ್ನು ದೇವನುಕೃಷ್ಣದೇವರಾಯನನ್ನು	ದ ೇ ವ ನ ು ಕ ೃ ಷ ್ ಣ ದ ೇ ವ ರ ಾ ಯ ನ ನ ್ ನ ು ದ ೇ ವ ನ ು ಕ ೃ ಷ ್ ಣ ದ ೇ ವ ರ ಾ ಯ ನ ನ ್ ನ ು	 PER
ಅತ್ಯಂತ ಅತ್ಯಂತ	ಅ ತ ್ ಯ ಂ ತ ಅ ತ ್ ಯ ಂ ತ	O
. .	. .	O
ಸೇರಲು ಸೇರಲು	ಸ ೇ ರ ಲ ು ಸ ೇ ರ ಲ ು	O
ಹಾಗೂ ಹಾಗೂ	ಹ ಾ ಗ ೂ ಹ ಾ ಗ ೂ	O
ಸಹಕಾರಿಯಾಗಿವೆ ಸಹಕಾರಿಯಾಗಿವೆ	ಸ ಹ ಕ ಾ ರ ಿ ಯ ಾ ಗ ಿ ವ ೆ ಸ ಹ ಕ ಾ ರ ಿ ಯ ಾ ಗ ಿ ವ ೆ	O
ವಿಜಯನಗರ ವಿಜಯನಗರ	ವ ಿ ಜ ಯ ನ ಗ ರ ವ ಿ ಜ ಯ ನ ಗ ರ	B-PER
	
ರಿಯಾಸತ್್ ರಿಯಾಸತ್್	ರ ಿ ಯ ಾ ಸ ತ ್ ್ ರ ಿ ಯ ಾ ಸ ತ ್ ್	O
ಬಯಸುವುದಿಲ್ಲವೆಂದು ಬಯಸುವುದಿಲ್ಲವೆಂದು	ಬ ಯ ಸ ು ವ ು ದ ಿ ಲ ್ ಲ ವ ೆ ಂ ದ ು ಬ ಯ ಸ ು ವ ು ದ ಿ ಲ ್ ಲ ವ ೆ ಂ ದ ು	O
ನೇಟಿವ್ ನೇಟಿವ್	ನ ೇ ಟ ಿ ವ ್ ನ ೇ ಟ ಿ ವ ್	O
ಸೋಲುಮಡನು ಸೋಲುಮಡನು	ಸ ೋ ಲ ು ಮ ಡ ನ ು ಸ ೋ ಲ ು ಮ ಡ ನ ು	O
ದೇವರು ದೇವರು	ದ ೇ ವ ರ ು ದ ೇ ವ ರ ು	O
ವಾಘ ವಾಘ	ವ ಾ ಘ ವ ಾ ಘ	 PER
ಗೆರಿಲ್ಲಾ ಗೆರಿಲ್ಲಾ	ಗ ೆ ರ ಿ ಲ ್ ಲ ಾ ಗ ೆ ರ ಿ ಲ ್ ಲ ಾ	O
ಮೇಲೆ ಮೇಲೆ	ಮ ೇ ಲ ೆ ಮ ೇ ಲ ೆ	O
ಅವಧಿಯಲ್ಲಿ ಅವಧಿಯಲ್ಲಿ	ಅ ವ ಧ ಿ ಯ ಲ ್ ಲ ಿ ಅ ವ ಧ ಿ ಯ ಲ ್ ಲ ಿ	O
ಎಂಬ ಎಂಬ	ಎ ಂ ಬ ಎ ಂ ಬ	O
ಭ್ರಷ್ಟಾಚಾರವು ಭ್ರಷ್ಟಾಚಾರವು	ಭ ್ ರ ಷ ್ ಟ ಾ ಚ ಾ ರ ವ ು ಭ ್ ರ ಷ ್ ಟ ಾ ಚ ಾ ರ ವ ು	O
ರಾಷ್ಟ್ರಕೂಟ ರಾಷ್ಟ್ರಕೂಟ	ರ ಾ ಷ ್ ಟ ್ ರ ಕ ೂ ಟ ರ ಾ ಷ ್ ಟ ್ ರ ಕ ೂ ಟ	O
ಈ ಈ	ಈ ಈ	O
. .	. .	O
ಅಭಿಜ್ಞಾನ ಅಭಿಜ್ಞಾನ	ಅ ಭ ಿ ಜ ್ ಞ ಾ ನ ಅ ಭ ಿ ಜ ್ ಞ ಾ ನ	O
ಅವನು ಅವನು	ಅ ವ ನ ು ಅ ವ ನ ು	O
ಪಾರಿಜಾತ ಪಾರಿಜಾತ	ಪ ಾ ರ ಿ ಜ ಾ ತ ಪ ಾ ರ ಿ ಜ ಾ ತ	B-LOC
ಇಟ್ಟಿಗೆಗಳ ಇಟ್ಟಿಗೆಗಳ	ಇ ಟ ್ ಟ ಿ ಗ ೆ ಗ ಳ ಇ ಟ ್ ಟ ಿ ಗ ೆ ಗ ಳ	O
. .	. .	O
ರಜಪೂತರು ರಜಪೂತರು	ರ ಜ ಪ ೂ ತ ರ ು ರ ಜ ಪ ೂ ತ ರ ು	B-COM
ಉಪಯೋಗ ಉಪಯೋಗ	ಉ ಪ ಯ ೋ ಗ ಉ ಪ ಯ ೋ ಗ	O
1012ರಲ್ಲಿ 1012ರಲ್ಲಿ	1 0 1 2 ರ ಲ ್ ಲ ಿ
ಕಂದಾಯವನ್ನು ಕಂದಾಯವನ್ನು	ಕ ಂ ದ ಾ ಯ ವ ನ ್ ನ ು ಕ ಂ ದ ಾ ಯ ವ ನ ್ ನ ು	O
, ,	, ,	O
ಅಂದಿನ ಅಂದಿನ	ಅ ಂ ದ ಿ ನ ಅ ಂ ದ ಿ ನ	O
ಕಾಲದ ಕಾಲದ	ಕ ಾ ಲ ದ ಕ ಾ ಲ ದ	TME
ಗಾಂಧಿಯವರು ಗಾಂಧಿಯವರು	ಗ ಾ ಂ ಧ ಿ ಯ ವ ರ ು ಗ ಾ ಂ ಧ ಿ ಯ ವ ರ ು	B-PER
	
ಹೆಸರಿಗೂ ಹೆಸರಿಗೂ	ಹ ೆ ಸ ರ ಿ ಗ ೂ ಹ ೆ ಸ ರ ಿ ಗ ೂ	O
ಎದು ಎದು	ಎ ದ ು ಎ ದ ು	O
. .	. .	O
ಬೀಗತನ ಬೀಗತನ	ಬ ೀ ಗ ತ ನ ಬ ೀ ಗ ತ ನ	O
ಮುದ್ರರಾಕ್ಷಸ ಮುದ್ರರಾಕ್ಷಸ	ಮ ು ದ ್ ರ ರ ಾ ಕ ್ ಷ ಸ ಮ ು ದ ್ ರ ರ ಾ ಕ ್ ಷ ಸ	O
	
೨೫ ೨೫	೨ ೫ ೨ ೫	TME
ಕೃಷ್ಣ ಕೃಷ್ಣ	ಕ ೃ ಷ ್ ಣ ಕ ೃ ಷ ್ ಣ	 PER
ರೀತಿಯಿಂದ ರೀತಿಯಿಂದ	ರ ೀ ತ ಿ ಯ ಿ ಂ ದ ರ ೀ ತ ಿ ಯ ಿ ಂ ದ	O
. .	. .	O
ಭೂಪಟದಲ್ಲಿ ಭೂಪಟದಲ್ಲಿ	ಭ ೂ ಪ ಟ ದ ಲ ್ ಲ ಿ ಭ ೂ ಪ ಟ ದ ಲ ್ ಲ ಿ	O
ವ್ಯವಹಾರ ವ್ಯವಹಾರ	ವ ್ ಯ ವ ಹ ಾ ರ ವ ್ ಯ ವ ಹ ಾ ರ	O
ಪ್ರಕಾರ ಪ್ರಕಾರ	ಪ ್ ರ ಕ ಾ ರ ಪ ್ ರ ಕ ಾ ರ	O
ಜಮೀನುದಾರರ ಜಮೀನುದಾರರ	ಜ ಮ ೀ ನ ು ದ ಾ ರ ರ ಜ ಮ ೀ ನ ು ದ ಾ ರ ರ	B-ROL
ಸೇನಾಪತಿಯಾದ ಸೇನಾಪತಿಯಾದ	ಸ ೇ ನ ಾ ಪ ತ ಿ ಯ ಾ ದ ಸ ೇ ನ ಾ ಪ ತ ಿ ಯ ಾ ದ	O
	೧೮೫೭ರ ಮಾರ್ಚಿನಲ್ಲಿ, ೩೪ನೇ ದೇಶೀಯ ಪದಾತಿದಳದ ಸಿಪಾಯಿಯಾದ ಮಂಗಲ (PER) ಪಾಂಡೆ, ಬ್ರಿಟಿಷ್ (ORG) ಸಾರ್ಜೆಂಟ್ (ದಳನಾಯಕ) ಒಬ್ಬನ ಮೇಲೆರಗಿ ಅಡ್‍ಜುಟೆಂಟ್ (ಸೇನಾಧಿಕಾರಿ) ಒಬ್ಬನಿಗೆ ಗಾಯ ಮಾಡಿದನು. ಜನರಲ್ (ಸೇನಾಪತಿ) ಹರ್ಸೇ (PER), ಪಾಂಡೆಗೆ ಯಾವುದೋ 'ಧರ್ಮದ ಮನೋವ್ಯಾಧಿ' ತಗುಲಿದೆಯೆನ್ನುತ್ತಾ, ಪಾಂಡೆಯನ್ನು ಬಂಧಿಸಲು ಜಮಾದಾರ (ಆರಕ್ಷಕ ಪ್ರಮುಖ) ನಿಗೆ ಆದೇಶಿಸಿದನಾದರೂ, ಬಂಧಿಸಲು ಆತ ನಿರಾಕರಿಸಿದನು. ಏಪ್ರಿಲ್ (TME) ೭ (TME) ರಂದು ಮಂಗಲ್ ಪಾಂಡೆಯನ್ನು ಜಮಾದಾರನೊಂದಿಗೆ ನೇಣು ಹಾಕಲಾಯಿತು. ಸಾಮೂಹಿಕ ಶಿಕ್ಷೆಯಾಗಿ (EVT) ಇಡೀ ತುಕಡಿಯನ್ನೇ ವಿಸರ್ಜಿಸಲಾಯಿತು. ಮೇ (TME) ೧೦ (TME) ರಂದು, ೧೧ (TME) ನೇ ಹಾಗೂ ೨೦ (TME) ನೇ ಅಶ್ವದಳಗಳು ಸೇರಿದಾಗ ಉಕ್ಕುವ ರೋಷದಿಂದ ಸವಾರರು ಅಧಿಕಾರಗಳ ಮಿತಿ ಮೀರಿ, ಮೇಲಧಿಕಾರಿಗಳನ್ನು ಬಗ್ಗು ಬಡಿದರು. ಅನಂತರ (TME) ೩ (TME) ನೇ ತುಕಡಿಯನ್ನು ಸ್ವತಂತ್ರಗೊಳಿಸಿದ ಅವರು, ಮೇ (TME) ೧೧ (TME) ರಂದು ದೆಹಲಿಯನ್ನು ತಲುಪಿದರು. ಅಲ್ಲಿ ಉಳಿದ ಭಾರತೀಯರು ಅವರನ್ನು ಸೇರಿಕೊಂಡರು. ಕೆಲಸಮಯದಲ್ಲಿ ಬಂಡಾಯವು ಉತ್ತರ ಭಾರತದ ತುಂಬೆಲ್ಲ ಹರಡಿತು. ಕೆಲವು ಮುಖ್ಯ ನಾಯಕರೆಂದರೆ ಅವಧ್ (LOC) ಪ್ರಾಂತ್ಯದ ಮಾಜಿ ದೊರೆಯ ಸಲಹೆಗಾರನಾದ ಅಹ್ಮದ್ (PER) ಉಲ್ಲಾ; ನಾನಾ ಸಾಹೇಬ್ (PER); ಅವನ ಸೋದರಳಿಯ ರಾವ್ (PER) ಸಾಹೇಬ್ (PER) ಮತ್ತವನ ಅನುಯಾಯಿಗಳಾದ ತಾಂತ್ಯಾ (PER) ಟೋಪ
ಭಾರತದ ಭಾರತದ	ಭ ಾ ರ ತ ದ ಭ ಾ ರ ತ ದ	O
. .	. .	O
. .	. .	O
ಮಾನವನಿಗೆ ಮಾನವನಿಗೆ	ಮ ಾ ನ ವ ನ ಿ ಗ ೆ ಮ ಾ ನ ವ ನ ಿ ಗ ೆ	O
ರಾತ್ರಿ ರಾತ್ರಿ	ರ ಾ ತ ್ ರ ಿ ರ ಾ ತ ್ ರ ಿ	O
ವಿಜಯನಗರದ ವಿಜಯನಗರದ	ವ ಿ ಜ ಯ ನ ಗ ರ ದ ವ ಿ ಜ ಯ ನ ಗ ರ ದ	B-LOC
ವೆಲೆಸ್ಲಿಯು ವೆಲೆಸ್ಲಿಯು	ವ ೆ ಲ ೆ ಸ ್ ಲ ಿ ಯ ು ವ ೆ ಲ ೆ ಸ ್ ಲ ಿ ಯ ು	 PER
ಧರ್ಮಸಹಿಷ್ಣುತೆಗೆ ಧರ್ಮಸಹಿಷ್ಣುತೆಗೆ	ಧ ರ ್ ಮ ಸ ಹ ಿ ಷ ್ ಣ ು ತ ೆ ಗ ೆ ಧ ರ ್ ಮ ಸ ಹ ಿ ಷ ್ ಣ ು ತ ೆ ಗ ೆ	O
1033ರಲ್ಲಿ 1033ರಲ್ಲಿ	1 0 3 3 ರ ಲ ್ ಲ ಿ
ಯುದ್ಧದ ಯುದ್ಧದ	ಯ ು ದ ್ ಧ ದ ಯ ು ದ ್ ಧ ದ	O
ಓರ್ವ ಓರ್ವ	ಓ ರ ್ ವ ಓ ರ ್ ವ	O
ಹೆಸರು ಹೆಸರು	ಹ ೆ ಸ ರ ು ಹ ೆ ಸ ರ ು	O
ಕ್ರಿ ಕ್ರಿ	ಕ ್ ರ ಿ ಕ ್ ರ ಿ	O
ತೋರುತ್ತದೆ ತೋರುತ್ತದೆ	ತ ೋ ರ ು ತ ್ ತ ದ ೆ ತ ೋ ರ ು ತ ್ ತ ದ ೆ	O
ಹತ್ತಿಕ್ಕಲು ಹತ್ತಿಕ್ಕಲು	ಹ ತ ್ ತ ಿ ಕ ್ ಕ ಲ ು ಹ ತ ್ ತ ಿ ಕ ್ ಕ ಲ ು	O
ಅಥವಾ ಅಥವಾ	ಅ ಥ ವ ಾ ಅ ಥ ವ ಾ	O
ಇದನ್ನು ಇದನ್ನು	ಇ ದ ನ ್ ನ ು ಇ ದ ನ ್ ನ ು	O
ನಿಲ್ಲಿಸಬೇಕಾಗಿತ್ತು ನಿಲ್ಲಿಸಬೇಕಾಗಿತ್ತು	ನ ಿ ಲ ್ ಲ ಿ ಸ ಬ ೇ ಕ ಾ ಗ ಿ ತ ್ ತ ು ನ ಿ ಲ ್ ಲ ಿ ಸ ಬ ೇ ಕ ಾ ಗ ಿ ತ ್ ತ ು	O
, ,	, ,	O
ಜೀವನವನ್ನು ಜೀವನವನ್ನು	ಜ ೀ ವ ನ ವ ನ ್ ನ ು ಜ ೀ ವ ನ ವ ನ ್ ನ ು	O
ಆಕ್ರಮಣ ಆಕ್ರಮಣ	ಆ ಕ ್ ರ ಮ ಣ ಆ ಕ ್ ರ ಮ ಣ	O
ಹೊರಟಿದ್ದ ಹೊರಟಿದ್ದ	ಹ ೊ ರ ಟ ಿ ದ ್ ದ ಹ ೊ ರ ಟ ಿ ದ ್ ದ	O
ಜೈನ ಜೈನ	ಜ ೈ ನ ಜ ೈ ನ	 LOC
ಭಾರತಕ್ಕೆ ಭಾರತಕ್ಕೆ	ಭ ಾ ರ ತ ಕ ್ ಕ ೆ ಭ ಾ ರ ತ ಕ ್ ಕ ೆ	B-LOC
೧೯೪೭ರಂದು ೧೯೪೭ರಂದು	೧ ೯ ೪ ೭ ರ ಂ ದ ು ೧ ೯ ೪ ೭ ರ ಂ ದ ು	TME
. .	. .	O
ಪಾರ್ಲಿಮೆಂಟಿನ ಪಾರ್ಲಿಮೆಂಟಿನ	ಪ ಾ ರ ್ ಲ ಿ ಮ ೆ ಂ ಟ ಿ ನ ಪ ಾ ರ ್ ಲ ಿ ಮ ೆ ಂ ಟ ಿ ನ	ORG
ಮಾಡಲಾಯಿತು ಮಾಡಲಾಯಿತು	ಮ ಾ ಡ ಲ ಾ ಯ ಿ ತ ು ಮ ಾ ಡ ಲ ಾ ಯ ಿ ತ ು	O
ಈ ಈ	ಈ ಈ	O
ನೇರ ನೇರ	ನ ೇ ರ ನ ೇ ರ	O
ಚಾಲುಕ್ಯರು ಚಾಲುಕ್ಯರು	ಚ ಾ ಲ ು ಕ ್ ಯ ರ ು ಚ ಾ ಲ ು ಕ ್ ಯ ರ ು	B-COM
ಕಾಲದವರೆಗೂ ಕಾಲದವರೆಗೂ	ಕ ಾ ಲ ದ ವ ರ ೆ ಗ ೂ ಕ ಾ ಲ ದ ವ ರ ೆ ಗ ೂ	O
ಹಲವಾರು ಹಲವಾರು	ಹ ಲ ವ ಾ ರ ು ಹ ಲ ವ ಾ ರ ು	O
. .	. .	O
	
ದಾದಾ ದಾದಾ	ದ ಾ ದ ಾ ದ ಾ ದ ಾ	 PER
. .	. .	O
. .	. .	O
ಆದ ಆದ	ಆ ದ ಆ ದ	O
ಹಿಂದೂ ಹಿಂದೂ	ಹ ಿ ಂ ದ ೂ ಹ ಿ ಂ ದ ೂ	B-COM
ಹಿಂದೂ ಹಿಂದೂ	ಹ ಿ ಂ ದ ೂ ಹ ಿ ಂ ದ ೂ	B-COM
ಅಲ್ಲಿಯೇ ಅಲ್ಲಿಯೇ	ಅ ಲ ್ ಲ ಿ ಯ ೇ ಅ ಲ ್ ಲ ಿ ಯ ೇ	O
ಇದರಿಂದ ಇದರಿಂದ	ಇ ದ ರ ಿ ಂ ದ ಇ ದ ರ ಿ ಂ ದ	O
	
ಸಾಮ್ರಾಜ್ಯ ಸಾಮ್ರಾಜ್ಯ	ಸ ಾ ಮ ್ ರ ಾ ಜ ್ ಯ ಸ ಾ ಮ ್ ರ ಾ ಜ ್ ಯ	I-COM
ದಾಳಿಯನ್ನು ದಾಳಿಯನ್ನು	ದ ಾ ಳ ಿ ಯ ನ ್ ನ ು ದ ಾ ಳ ಿ ಯ ನ ್ ನ ು	O
ಚೆನ್ನಬಸಪ್ಪನ ಚೆನ್ನಬಸಪ್ಪನ	ಚ ೆ ನ ್ ನ ಬ ಸ ಪ ್ ಪ ನ ಚ ೆ ನ ್ ನ ಬ ಸ ಪ ್ ಪ ನ	B-PER
ಕಂಪನಿಯ ಕಂಪನಿಯ	ಕ ಂ ಪ ನ ಿ ಯ ಕ ಂ ಪ ನ ಿ ಯ	ORG
ಹೊಯ್ಸಳ ಹೊಯ್ಸಳ	ಹ ೊ ಯ ್ ಸ ಳ ಹ ೊ ಯ ್ ಸ ಳ	B-COM
ಹಿಮಾಲಯದ ಹಿಮಾಲಯದ	ಹ ಿ ಮ ಾ ಲ ಯ ದ ಹ ಿ ಮ ಾ ಲ ಯ ದ	B-LOC
ತಮ್ಮ ತಮ್ಮ	ತ ಮ ್ ಮ ತ ಮ ್ ಮ	O
ತಿಳಿಸಿರುವಂತೆ ತಿಳಿಸಿರುವಂತೆ	ತ ಿ ಳ ಿ ಸ ಿ ರ ು ವ ಂ ತ ೆ ತ ಿ ಳ ಿ ಸ ಿ ರ ು ವ ಂ ತ ೆ	O
. .	. .	O
ತಮ್ಮದೇ ತಮ್ಮದೇ	ತ ಮ ್ ಮ ದ ೇ ತ ಮ ್ ಮ ದ ೇ	O
ನಿರಾಕರಿಸಿ ನಿರಾಕರಿಸಿ	ನ ಿ ರ ಾ ಕ ರ ಿ ಸ ಿ ನ ಿ ರ ಾ ಕ ರ ಿ ಸ ಿ	O
	
ಅವರ ಅವರ	ಅ ವ ರ ಅ ವ ರ	O
ಕೂಡಿಸಿದನಂತೆ ಕೂಡಿಸಿದನಂತೆ	ಕ ೂ ಡ ಿ ಸ ಿ ದ ನ ಂ ತ ೆ ಕ ೂ ಡ ಿ ಸ ಿ ದ ನ ಂ ತ ೆ	O
. .	. .	O
ಆಗಿತ್ತು ಆಗಿತ್ತು	ಆ ಗ ಿ ತ ್ ತ ು ಆ ಗ ಿ ತ ್ ತ ು	O
ಮಕ್ಕಳೊಡನೆ ಮಕ್ಕಳೊಡನೆ	ಮ ಕ ್ ಕ ಳ ೊ ಡ ನ ೆ ಮ ಕ ್ ಕ ಳ ೊ ಡ ನ ೆ	O
ಕರ್ನಾಟಕದ ಕರ್ನಾಟಕದ	ಕ ರ ್ ನ ಾ ಟ ಕ ದ ಕ ರ ್ ನ ಾ ಟ ಕ ದ	B-LOC
ಕೃತಿಯಲ್ಲಿ ಕೃತಿಯಲ್ಲಿ	ಕ ೃ ತ ಿ ಯ ಲ ್ ಲ ಿ ಕ ೃ ತ ಿ ಯ ಲ ್ ಲ ಿ	O
ಇನ್ನು ಇನ್ನು	ಇ ನ ್ ನ ು ಇ ನ ್ ನ ು	O
	
ಮರಣದ ಮರಣದ	ಮ ರ ಣ ದ ಮ ರ ಣ ದ	O
. .	. .	O
ದೊರೆ ದೊರೆ	ದ ೊ ರ ೆ ದ ೊ ರ ೆ	O
3ನೇ 3ನೇ	3 ನ ೇ
ರಚಿಸಿದನು ರಚಿಸಿದನು	ರ ಚ ಿ ಸ ಿ ದ ನ ು ರ ಚ ಿ ಸ ಿ ದ ನ ು	O
. .	. .	O
ಘನತೆ ಘನತೆ	ಘ ನ ತ ೆ ಘ ನ ತ ೆ	O
ಹಾಗೂ ಹಾಗೂ	ಹ ಾ ಗ ೂ ಹ ಾ ಗ ೂ	O
ನಾಲ್ಕನೆಯ ನಾಲ್ಕನೆಯ	ನ ಾ ಲ ್ ಕ ನ ೆ ಯ
ಕಲ್ಲುಮಠದ ಕಲ್ಲುಮಠದ	ಕ ಲ ್ ಲ ು ಮ ಠ ದ ಕ ಲ ್ ಲ ು ಮ ಠ ದ	O
ಸಮಯಕ್ಕೆ ಸಮಯಕ್ಕೆ	ಸ ಮ ಯ ಕ ್ ಕ ೆ ಸ ಮ ಯ ಕ ್ ಕ ೆ	O
ವಿರುದ್ಧವಾಗಿ ವಿರುದ್ಧವಾಗಿ	ವ ಿ ರ ು ದ ್ ಧ ವ ಾ ಗ ಿ ವ ಿ ರ ು ದ ್ ಧ ವ ಾ ಗ ಿ	O
ನುಗ್ಗಿ ನುಗ್ಗಿ	ನ ು ಗ ್ ಗ ಿ ನ ು ಗ ್ ಗ ಿ	O
	
ಎಂಬ ಎಂಬ	ಎ ಂ ಬ ಎ ಂ ಬ	O
, ,	, ,	O
ನಂತರ ನಂತರ	ನ ಂ ತ ರ ನ ಂ ತ ರ	O
ಮಂದಿ ಮಂದಿ	ಮ ಂ ದ ಿ ಮ ಂ ದ ಿ	O
ಎ ಎ	ಎ ಎ	O
. .	. .	O
ಅವರ ಅವರ	ಅ ವ ರ ಅ ವ ರ	O
	
ಮುಂದುವರಿಯಿತು ಮುಂದುವರಿಯಿತು	ಮ ು ಂ ದ ು ವ ರ ಿ ಯ ಿ ತ ು ಮ ು ಂ ದ ು ವ ರ ಿ ಯ ಿ ತ ು	O
. .	. .	O
ಅಭ್ಯುದಯ ಅಭ್ಯುದಯ	ಅ ಭ ್ ಯ ು ದ ಯ ಅ ಭ ್ ಯ ು ದ ಯ	O
ವೆಂಗಿಚಾಲುಕ್ಯರ ವೆಂಗಿಚಾಲುಕ್ಯರ	ವ ೆ ಂ ಗ ಿ ಚ ಾ ಲ ು ಕ ್ ಯ ರ ವ ೆ ಂ ಗ ಿ ಚ ಾ ಲ ು ಕ ್ ಯ ರ	B-PER
ಮನೆಮಾತಾಗಿದೆ ಮನೆಮಾತಾಗಿದೆ	ಮ ನ ೆ ಮ ಾ ತ ಾ ಗ ಿ ದ ೆ ಮ ನ ೆ ಮ ಾ ತ ಾ ಗ ಿ ದ ೆ	O
ಸಂದರ್ಭದಲ್ಲಿ ಸಂದರ್ಭದಲ್ಲಿ	ಸ ಂ ದ ರ ್ ಭ ದ ಲ ್ ಲ ಿ ಸ ಂ ದ ರ ್ ಭ ದ ಲ ್ ಲ ಿ	O
ಆತ ಆತ	ಆ ತ ಆ ತ	O
ಗೋಪುರಗಳು ಗೋಪುರಗಳು	ಗ ೋ ಪ ು ರ ಗ ಳ ು ಗ ೋ ಪ ು ರ ಗ ಳ ು	O
ಏಕೀಕರಣದ ಏಕೀಕರಣದ	ಏ ಕ ೀ ಕ ರ ಣ ದ ಏ ಕ ೀ ಕ ರ ಣ ದ	O
ಜೀವಕ್ಕೆ ಜೀವಕ್ಕೆ	ಜ ೀ ವ ಕ ್ ಕ ೆ ಜ ೀ ವ ಕ ್ ಕ ೆ	O
ರಿಂದ ರಿಂದ	ರ ಿ ಂ ದ ರ ಿ ಂ ದ	O
ಗಂಭೀರ ಗಂಭೀರ	ಗ ಂ ಭ ೀ ರ ಗ ಂ ಭ ೀ ರ	O
ಪಲ್ಲವ ಪಲ್ಲವ	ಪ ಲ ್ ಲ ವ ಪ ಲ ್ ಲ ವ	B-COM
ದೇವಿಗೆ ದೇವಿಗೆ	ದ ೇ ವ ಿ ಗ ೆ ದ ೇ ವ ಿ ಗ ೆ	B-PER
ಗೂರ್ಜರ ಗೂರ್ಜರ	ಗ ೂ ರ ್ ಜ ರ ಗ ೂ ರ ್ ಜ ರ	B-COM
೧೯೫೦ರಂದು ೧೯೫೦ರಂದು	೧ ೯ ೫ ೦ ರ ಂ ದ ು ೧ ೯ ೫ ೦ ರ ಂ ದ ು	TME
೩೩ ೩೩	೩ ೩
. .	. .	O
	
ಆದರೆ ಆದರೆ	ಆ ದ ರ ೆ ಆ ದ ರ ೆ	O
ಎಂದು ಎಂದು	ಎ ಂ ದ ು ಎ ಂ ದ ು	O
	
ಸನ್ನಿಧಿಯಲ್ಲಿ ಸನ್ನಿಧಿಯಲ್ಲಿ	ಸ ನ ್ ನ ಿ ಧ ಿ ಯ ಲ ್ ಲ ಿ ಸ ನ ್ ನ ಿ ಧ ಿ ಯ ಲ ್ ಲ ಿ	O
ಪರಿಣಾಮವಾಗಿ ಪರಿಣಾಮವಾಗಿ	ಪ ರ ಿ ಣ ಾ ಮ ವ ಾ ಗ ಿ ಪ ರ ಿ ಣ ಾ ಮ ವ ಾ ಗ ಿ	O
. .	. .	O
ಹೋಸ ಹೋಸ	ಹ ೋ ಸ ಹ ೋ ಸ	O
ಯಶಸ್ಸು ಯಶಸ್ಸು	ಯ ಶ ಸ ್ ಸ ು ಯ ಶ ಸ ್ ಸ ು	O
ವಿಂಗಡಿಸಲಾಗಿತ್ತು ವಿಂಗಡಿಸಲಾಗಿತ್ತು	ವ ಿ ಂ ಗ ಡ ಿ ಸ ಲ ಾ ಗ ಿ ತ ್ ತ ು ವ ಿ ಂ ಗ ಡ ಿ ಸ ಲ ಾ ಗ ಿ ತ ್ ತ ು	O
ಗುಡಿಸಿ ಗುಡಿಸಿ	ಗ ು ಡ ಿ ಸ ಿ ಗ ು ಡ ಿ ಸ ಿ	O
ಸ್ಥಳದಿಂದಲೇ ಸ್ಥಳದಿಂದಲೇ	ಸ ್ ಥ ಳ ದ ಿ ಂ ದ ಲ ೇ ಸ ್ ಥ ಳ ದ ಿ ಂ ದ ಲ ೇ	O
ನೋಡಬಹುದು ನೋಡಬಹುದು	ನ ೋ ಡ ಬ ಹ ು ದ ು ನ ೋ ಡ ಬ ಹ ು ದ ು	O
ಕಾಂಗ್ರೆಸ್ನ ಕಾಂಗ್ರೆಸ್ನ	ಕ ಾ ಂ ಗ ್ ರ ೆ ಸ ್ ನ ಕ ಾ ಂ ಗ ್ ರ ೆ ಸ ್ ನ	ORG
ವಹಿಸಿಕೊಂಡಾಗ ವಹಿಸಿಕೊಂಡಾಗ	ವ ಹ ಿ ಸ ಿ ಕ ೊ ಂ ಡ ಾ ಗ ವ ಹ ಿ ಸ ಿ ಕ ೊ ಂ ಡ ಾ ಗ	O
ಶಾಸನವನ್ನು ಶಾಸನವನ್ನು	ಶ ಾ ಸ ನ ವ ನ ್ ನ ು ಶ ಾ ಸ ನ ವ ನ ್ ನ ು	O
ಸಭೆಯಲ್ಲಿ ಸಭೆಯಲ್ಲಿ	ಸ ಭ ೆ ಯ ಲ ್ ಲ ಿ ಸ ಭ ೆ ಯ ಲ ್ ಲ ಿ	O
. .	. .	O
೧೯೩೦ ೧೯೩೦	೧ ೯ ೩ ೦ ೧ ೯ ೩ ೦	TME
ಮೊದಲಾದವು ಮೊದಲಾದವು	ಮ ೊ ದ ಲ ಾ ದ ವ ು ಮ ೊ ದ ಲ ಾ ದ ವ ು	O
ಮತ್ತು ಮತ್ತು	ಮ ತ ್ ತ ು ಮ ತ ್ ತ ು	O
	
ರಾಷ್ಟ್ರೀಯ ರಾಷ್ಟ್ರೀಯ	ರ ಾ ಷ ್ ಟ ್ ರ ಿ ೕ ಯ ರ ಾ ಷ ್ ಟ ್ ರ ಿ ೕ ಯ	ORG
ನೀಡಿ ನೀಡಿ	ನ ೀ ಡ ಿ ನ ೀ ಡ ಿ	O
ಸಮರ್ಥನಾದ ಸಮರ್ಥನಾದ	ಸ ಮ ರ ್ ಥ ನ ಾ ದ ಸ ಮ ರ ್ ಥ ನ ಾ ದ	O
ತಾಲ್ಲುಕುಗಳು೪ ತಾಲ್ಲುಕುಗಳು೪	ತ ಾ ಲ ್ ಲ ು ಕ ು ಗ ಳ ು ೪ ತ ಾ ಲ ್ ಲ ು ಕ ು ಗ ಳ ು ೪	O
ಬಣ್ಣದ ಬಣ್ಣದ	ಬ ಣ ್ ಣ ದ ಬ ಣ ್ ಣ ದ	O
ಶ ಶ	ಶ ಶ	O
	
ಪು ಪು	ಪ ು ಪ ು	O
ಅಷ್ಟೊಂದು ಅಷ್ಟೊಂದು	ಅ ಷ ್ ಟ ೊ ಂ ದ ು ಅ ಷ ್ ಟ ೊ ಂ ದ ು	O
ಬಹಮನಿ ಬಹಮನಿ	ಬ ಹ ಮ ನ ಿ ಬ ಹ ಮ ನ ಿ	B-COM
1837ರಂದು 1837ರಂದು	1 8 3 7 ರ ಂ ದ ು 1 8 3 7 ರ ಂ ದ ು	TME
. .	. .	O
ಜನ ಜನ	ಜ ನ ಜ ನ	O
ಬಾಯಿ ಬಾಯಿ	ಬ ಾ ಯ ಿ ಬ ಾ ಯ ಿ	 PER
ಕಾಂಗ್ರೆಸ್ನಿಂದ ಕಾಂಗ್ರೆಸ್ನಿಂದ	ಕ ಾ ಂ ಗ ್ ರ ೆ ಸ ್ ನ ಿ ಂ ದ ಕ ಾ ಂ ಗ ್ ರ ೆ ಸ ್ ನ ಿ ಂ ದ	ORG
, ,	, ,	O
